;lemmas;df_2021;df_2022;total;min;std;mean;max
1;datum;158;29;187;29;91.22;93.5;158
2;xml;87;18;105;18;48.79;52.5;87
3;result;63;8;71;8;38.89;35.5;63
4;analysis;54;6;60;6;33.94;30.0;54
5;study;45;6;51;6;27.58;25.5;45
6;clinical;38;9;47;9;20.51;23.5;38
7;use;36;9;45;9;19.09;22.5;36
8;base;32;12;44;12;14.14;22.0;32
9;format;26;15;41;15;7.78;20.5;26
10;process;37;3;40;3;24.04;20.0;37
11;system;34;5;39;5;20.51;19.5;34
12;method;24;12;36;12;8.49;18.0;24
13;model;31;4;35;4;19.09;17.5;31
14;standard;32;2;34;2;21.21;17.0;32
15;tool;17;15;32;15;1.41;16.0;17
16;include;29;2;31;2;19.09;15.5;29
17;time;24;6;30;6;12.73;15.0;24
18;file;22;7;29;7;10.61;14.5;22
19;metadata;27;1;28;1;18.38;14.0;27
20;term;23;5;28;5;12.73;14.0;23
21;treatment;27;1;28;1;18.38;14.0;27
22;research;19;7;26;7;8.49;13.0;19
23;develope;16;10;26;10;4.24;13.0;16
24;open;17;8;25;8;6.36;12.5;17
25;identify;23;2;25;2;14.85;12.5;23
26;cell;24;0;24;0;16.97;12.0;24
27;new;19;5;24;5;9.9;12.0;19
28;patient;23;1;24;1;15.56;12.0;23
29;fhir;23;0;23;0;16.26;11.5;23
30;control;19;4;23;4;10.61;11.5;19
31;provide;20;2;22;2;12.73;11.0;20
32;different;11;11;22;11;0.0;11.0;11
33;present;14;8;22;8;4.24;11.0;14
34;conclusion;17;5;22;5;8.49;11.0;17
35;high;16;6;22;6;7.07;11.0;16
36;increase;16;6;22;6;7.07;11.0;16
37;scheme;22;0;22;0;15.56;11.0;22
38;article;22;0;22;0;15.56;11.0;22
39;support;16;6;22;6;7.07;11.0;16
40;paper;18;3;21;3;10.61;10.5;18
41;target;15;6;21;6;6.36;10.5;15
42;structure;18;3;21;3;10.61;10.5;18
43;report;19;2;21;2;12.02;10.5;19
44;expression;16;5;21;5;7.78;10.5;16
45;information;11;10;21;10;0.71;10.5;11
46;language;14;7;21;7;4.95;10.5;14
47;+;20;0;20;0;14.14;10.0;20
48;perform;17;3;20;3;9.9;10.0;17
49;software;14;5;19;5;6.36;9.5;14
50;source;9;10;19;9;0.71;9.5;10
51;value;16;3;19;3;9.19;9.5;16
52;design;13;6;19;6;4.95;9.5;13
53;effect;15;4;19;4;7.78;9.5;15
54;type;15;4;19;4;7.78;9.5;15
55;code;19;0;19;0;13.44;9.5;19
56;solution;18;1;19;1;12.02;9.5;18
57;health;17;1;18;1;11.31;9.0;17
58;scientific;17;1;18;1;11.31;9.0;17
59;resource;17;1;18;1;11.31;9.0;17
60;tumor;17;1;18;1;11.31;9.0;17
61;extract;16;2;18;2;9.9;9.0;16
62;ct;18;0;18;0;12.73;9.0;18
63;exchange;15;3;18;3;8.49;9.0;15
64;network;16;1;17;1;10.61;8.5;16
65;relate;16;1;17;1;10.61;8.5;16
66;induce;17;0;17;0;12.02;8.5;17
67;application;14;3;17;3;7.78;8.5;14
68;propose;15;2;17;2;9.19;8.5;15
69;document;14;3;17;3;7.78;8.5;14
70;gap;12;5;17;5;4.95;8.5;12
71;need;11;6;17;6;3.54;8.5;11
72;conduct;16;1;17;1;10.61;8.5;16
73;text;12;4;16;4;5.66;8.0;12
74;database;13;3;16;3;7.07;8.0;13
75;trial;16;0;16;0;11.31;8.0;16
76;group;15;1;16;1;9.9;8.0;15
77;molecular;13;3;16;3;7.07;8.0;13
78;potential;12;4;16;4;5.66;8.0;12
79;1;16;0;16;0;11.31;8.0;16
80;search;12;4;16;4;5.66;8.0;12
81;mechanism;13;3;16;3;7.07;8.0;13
82;drug;15;1;16;1;9.9;8.0;15
83;approach;13;3;16;3;7.07;8.0;13
84;publication;15;1;16;1;9.9;8.0;15
85;library;3;12;15;3;6.36;7.5;12
86;content;13;2;15;2;7.78;7.5;13
87;compare;11;4;15;4;4.95;7.5;11
88;sdc;15;0;15;0;10.61;7.5;15
89;validation;15;0;15;0;10.61;7.5;15
90;implementation;15;0;15;0;10.61;7.5;15
91;review;13;2;15;2;7.78;7.5;13
92;level;13;2;15;2;7.78;7.5;13
93;user;3;12;15;3;6.36;7.5;12
94;development;12;3;15;3;6.36;7.5;12
95;cocaine;15;0;15;0;10.61;7.5;15
96;large;13;2;15;2;7.78;7.5;13
97;medicine;11;3;14;3;5.66;7.0;11
98;covid-19;14;0;14;0;9.9;7.0;14
99;injection;9;5;14;5;2.83;7.0;9
100;follow;12;2;14;2;7.07;7.0;12
101;case;14;0;14;0;9.9;7.0;14
102;update;13;1;14;1;8.49;7.0;13
103;complex;12;2;14;2;7.07;7.0;12
104;parameter;8;6;14;6;1.41;7.0;8
105;web;8;6;14;6;1.41;7.0;8
106;element;14;0;14;0;9.9;7.0;14
107;function;11;3;14;3;5.66;7.0;11
108;work;10;3;13;3;4.95;6.5;10
109;cancer;9;4;13;4;3.54;6.5;9
110;framework;13;0;13;0;9.19;6.5;13
111;dataset;13;0;13;0;9.19;6.5;13
112;set;8;5;13;5;2.12;6.5;8
113;collection;13;0;13;0;9.19;6.5;13
114;rdf;13;0;13;0;9.19;6.5;13
115;allow;11;2;13;2;6.36;6.5;11
116;medical;10;3;13;3;4.95;6.5;10
117;pubmed;10;3;13;3;4.95;6.5;10
118;protein;12;1;13;1;7.78;6.5;12
119;population;13;0;13;0;9.19;6.5;13
120;management;13;0;13;0;9.19;6.5;13
121;challenge;12;1;13;1;7.78;6.5;12
122;test;13;0;13;0;9.19;6.5;13
123;evaluate;9;4;13;4;3.54;6.5;9
124;analyze;11;2;13;2;6.36;6.5;11
125;metabolism;11;1;12;1;7.07;6.0;11
126;aim;10;2;12;2;5.66;6.0;10
127;create;10;2;12;2;5.66;6.0;10
128;interoperability;9;3;12;3;4.24;6.0;9
129;gene;10;2;12;2;5.66;6.0;10
130;image;10;2;12;2;5.66;6.0;10
131;find;11;1;12;1;7.07;6.0;11
132;specific;12;0;12;0;8.49;6.0;12
133;capture;12;0;12;0;8.49;6.0;12
134;pathway;11;1;12;1;7.07;6.0;11
135;component;10;2;12;2;5.66;6.0;10
136;share;7;5;12;5;1.41;6.0;7
137;human;7;5;12;5;1.41;6.0;7
138;improve;10;2;12;2;5.66;6.0;10
139;demonstrate;10;1;11;1;6.36;5.5;10
140;map;11;0;11;0;7.78;5.5;11
141;facilitate;11;0;11;0;7.78;5.5;11
142;available;9;2;11;2;4.95;5.5;9
143;cdisc;11;0;11;0;7.78;5.5;11
144;error;8;3;11;3;3.54;5.5;8
145;rate;10;1;11;1;6.36;5.5;10
146;label;10;1;11;1;6.36;5.5;10
147;implement;11;0;11;0;7.78;5.5;11
148;representation;9;2;11;2;4.95;5.5;9
149;markup;7;4;11;4;2.12;5.5;7
150;significantly;9;2;11;2;4.95;5.5;9
151;quality;8;3;11;3;3.54;5.5;8
152;algorithm;7;4;11;4;2.12;5.5;7
153;show;8;3;11;3;3.54;5.5;8
154;national;5;6;11;5;0.71;5.5;6
155;r;10;1;11;1;6.36;5.5;10
156;general;9;2;11;2;4.95;5.5;9
157;ecgs;10;0;10;0;7.07;5.0;10
158;compound;9;1;10;1;5.66;5.0;9
159;main;7;3;10;3;2.83;5.0;7
160;researcher;7;3;10;3;2.83;5.0;7
161;enable;6;4;10;4;1.41;5.0;6
162;access;9;1;10;1;5.66;5.0;9
163;evaluation;4;6;10;4;1.41;5.0;6
164;performance;7;3;10;3;2.83;5.0;7
165;kidney;10;0;10;0;7.07;5.0;10
166;oxidative;10;0;10;0;7.07;5.0;10
167;schema;10;0;10;0;7.07;5.0;10
168;statistical;10;0;10;0;7.07;5.0;10
169;significant;10;0;10;0;7.07;5.0;10
170;reduce;7;3;10;3;2.83;5.0;7
171;healthcare;9;1;10;1;5.66;5.0;9
172;x;7;3;10;3;2.83;5.0;7
173;stress;10;0;10;0;7.07;5.0;10
174;terminology;9;1;10;1;5.66;5.0;9
175;common;9;1;10;1;5.66;5.0;9
176;query;10;0;10;0;7.07;5.0;10
177;annotation;1;9;10;1;5.66;5.0;9
178;live;10;0;10;0;7.07;5.0;10
179;dox;10;0;10;0;7.07;5.0;10
180;effective;9;0;9;0;6.36;4.5;9
181;easy;8;1;9;1;4.95;4.5;8
182;platform;4;5;9;4;0.71;4.5;5
183;chinese;8;1;9;1;4.95;4.5;8
184;mobile;9;0;9;0;6.36;4.5;9
185;domain;9;0;9;0;6.36;4.5;9
186;ecg;7;2;9;2;3.54;4.5;7
187;integration;9;0;9;0;6.36;4.5;9
188;meta;9;0;9;0;6.36;4.5;9
189;tcmis;9;0;9;0;6.36;4.5;9
190;transformation;9;0;9;0;6.36;4.5;9
191;original;7;2;9;2;3.54;4.5;7
192;risk;9;0;9;0;6.36;4.5;9
193;ng;0;9;9;0;6.36;4.5;9
194;focus;5;4;9;4;0.71;4.5;5
195;automate;7;2;9;2;3.54;4.5;7
196;community;9;0;9;0;6.36;4.5;9
197;compliant;9;0;9;0;6.36;4.5;9
198;output;6;3;9;3;2.12;4.5;6
199;standardize;5;4;9;4;0.71;4.5;5
200;yield;9;0;9;0;6.36;4.5;9
201;antibody;9;0;9;0;6.36;4.5;9
202;p;9;0;9;0;6.36;4.5;9
203;extraction;8;1;9;1;4.95;4.5;8
204;obtain;6;3;9;3;2.12;4.5;6
205;exist;8;1;9;1;4.95;4.5;8
206;ord;9;0;9;0;6.36;4.5;9
207;issue;8;1;9;1;4.95;4.5;8
208;input;8;1;9;1;4.95;4.5;8
209;produce;8;1;9;1;4.95;4.5;8
210;ms;1;8;9;1;4.95;4.5;8
211;species;0;9;9;0;6.36;4.5;9
212;technique;7;2;9;2;3.54;4.5;7
213;multiple;8;1;9;1;4.95;4.5;8
214;package;8;0;8;0;5.66;4.0;8
215;literature;7;1;8;1;4.24;4.0;7
216;highly;5;3;8;3;1.41;4.0;5
217;tissue;8;0;8;0;5.66;4.0;8
218;year;5;3;8;3;1.41;4.0;5
219;objective;6;2;8;2;2.83;4.0;6
220;rat;5;3;8;3;1.41;4.0;5
221;jatsdecoder;8;0;8;0;5.66;4.0;8
222;apache;8;0;8;0;5.66;4.0;8
223;professional;8;0;8;0;5.66;4.0;8
224;version;6;2;8;2;2.83;4.0;6
225;simple;7;1;8;1;4.24;4.0;7
226;mesh;0;8;8;0;5.66;4.0;8
227;ctims;8;0;8;0;5.66;4.0;8
228;response;8;0;8;0;5.66;4.0;8
229;field;3;5;8;3;1.41;4.0;5
230;real;8;0;8;0;5.66;4.0;8
231;brugada;8;0;8;0;5.66;4.0;8
232;total;7;1;8;1;4.24;4.0;7
233;miind;8;0;8;0;5.66;4.0;8
234;m6a;8;0;8;0;5.66;4.0;8
235;build;6;2;8;2;2.83;4.0;6
236;offer;6;2;8;2;2.83;4.0;6
237;xylitol;8;0;8;0;5.66;4.0;8
238;detect;8;0;8;0;5.66;4.0;8
239;require;7;1;8;1;4.24;4.0;7
240;class;6;2;8;2;2.83;4.0;6
241;safety;7;1;8;1;4.24;4.0;7
242;publish;6;2;8;2;2.83;4.0;6
243;efficacy;8;0;8;0;5.66;4.0;8
244;numb;7;1;8;1;4.24;4.0;7
245;project;8;0;8;0;5.66;4.0;8
246;tag;5;2;7;2;2.12;3.5;5
247;pseudonymization;7;0;7;0;4.95;3.5;7
248;covid;7;0;7;0;4.95;3.5;7
249;heart;6;1;7;1;3.54;3.5;6
250;treat;7;0;7;0;4.95;3.5;7
251;disease;7;0;7;0;4.95;3.5;7
252;dysfunction;7;0;7;0;4.95;3.5;7
253;rct;7;0;7;0;4.95;3.5;7
254;failure;5;2;7;2;2.12;3.5;5
255;reference;6;1;7;1;3.54;3.5;6
256;conjugate;7;0;7;0;4.95;3.5;7
257;care;5;2;7;2;2.12;3.5;5
258;example;6;1;7;1;3.54;3.5;6
259;underlie;6;1;7;1;3.54;3.5;6
260;get.stats;7;0;7;0;4.95;3.5;7
261;compute;7;0;7;0;4.95;3.5;7
262;specification;6;1;7;1;3.54;3.5;6
263;syndrome;7;0;7;0;4.95;3.5;7
264;sd;2;5;7;2;2.12;3.5;5
265;2;7;0;7;0;4.95;3.5;7
266;attenuate;5;2;7;2;2.12;3.5;5
267;energy;7;0;7;0;4.95;3.5;7
268;speed;7;0;7;0;4.95;3.5;7
269;neuron;7;0;7;0;4.95;3.5;7
270;direct;3;4;7;3;0.71;3.5;4
271;maximum;7;0;7;0;4.95;3.5;7
272;scale;7;0;7;0;4.95;3.5;7
273;program;6;1;7;1;3.54;3.5;6
274;active;7;0;7;0;4.95;3.5;7
275;survey;5;2;7;2;2.12;3.5;5
276;ophthalmology;7;0;7;0;4.95;3.5;7
277;enzymeml;7;0;7;0;4.95;3.5;7
278;site;7;0;7;0;4.95;3.5;7
279;mean;7;0;7;0;4.95;3.5;7
280;redcap;7;0;7;0;4.95;3.5;7
281;lps;7;0;7;0;4.95;3.5;7
282;write;7;0;7;0;4.95;3.5;7
283;5;5;2;7;2;2.12;3.5;5
284;basis;7;0;7;0;4.95;3.5;7
285;electronic;7;0;7;0;4.95;3.5;7
286;lc;0;7;7;0;4.95;3.5;7
287;e;0;7;7;0;4.95;3.5;7
288;ensure;6;1;7;1;3.54;3.5;6
289;extensible;6;1;7;1;3.54;3.5;6
290;myocardial;0;7;7;0;4.95;3.5;7
291;associate;6;1;7;1;3.54;3.5;6
292;ischemia;0;7;7;0;4.95;3.5;7
293;expert;5;2;7;2;2.12;3.5;5
294;record;7;0;7;0;4.95;3.5;7
295;check;5;2;7;2;2.12;3.5;5
296;simulation;7;0;7;0;4.95;3.5;7
297;parathyroid;0;7;7;0;4.95;3.5;7
298;b2n;0;7;7;0;4.95;3.5;7
299;future;6;1;7;1;3.54;3.5;6
300;substitution;7;0;7;0;4.95;3.5;7
301;country;7;0;7;0;4.95;3.5;7
302;partition;0;7;7;0;4.95;3.5;7
303;important;5;2;7;2;2.12;3.5;5
304;assessment;6;0;6;0;4.24;3.0;6
305;ch;6;0;6;0;4.24;3.0;6
306;anno;0;6;6;0;4.24;3.0;6
307;ray;6;0;6;0;4.24;3.0;6
308;emission;6;0;6;0;4.24;3.0;6
309;investigate;6;0;6;0;4.24;3.0;6
310;establish;5;1;6;1;2.83;3.0;5
311;extend;6;0;6;0;4.24;3.0;6
312;material;4;2;6;2;1.41;3.0;4
313;hl7;6;0;6;0;4.24;3.0;6
314;our2d2;6;0;6;0;4.24;3.0;6
315;usage;2;4;6;2;1.41;3.0;4
316;individual;5;1;6;1;2.83;3.0;5
317;help;4;2;6;2;1.41;3.0;4
318;possible;5;1;6;1;2.83;3.0;5
319;module;6;0;6;0;4.24;3.0;6
320;sdtm;6;0;6;0;4.24;3.0;6
321;export;3;3;6;3;0.0;3.0;3
322;website;3;3;6;3;0.0;3.0;3
323;lysosomal;6;0;6;0;4.24;3.0;6
324;monitor;3;3;6;3;0.0;3.0;3
325;subject;2;4;6;2;1.41;3.0;4
326;form;5;1;6;1;2.83;3.0;5
327;pgc-1alpha;6;0;6;0;4.24;3.0;6
328;technology;3;3;6;3;0.0;3.0;3
329;mitochondrial;6;0;6;0;4.24;3.0;6
330;overall;4;2;6;2;1.41;3.0;4
331;immune;6;0;6;0;4.24;3.0;6
332;name;6;0;6;0;4.24;3.0;6
333;4;5;1;6;1;2.83;3.0;5
334;non;3;3;6;3;0.0;3.0;3
335;31;6;0;6;0;4.24;3.0;6
336;lncrna;6;0;6;0;4.24;3.0;6
337;openehr;6;0;6;0;4.24;3.0;6
338;cluster;6;0;6;0;4.24;3.0;6
339;determine;6;0;6;0;4.24;3.0;6
340;therapy;6;0;6;0;4.24;3.0;6
341;eczema;6;0;6;0;4.24;3.0;6
342;detection;4;2;6;2;1.41;3.0;4
343;size;6;0;6;0;4.24;3.0;6
344;big;6;0;6;0;4.24;3.0;6
345;efficient;6;0;6;0;4.24;3.0;6
346;phone;6;0;6;0;4.24;3.0;6
347;2020;5;1;6;1;2.83;3.0;5
348;contain;3;3;6;3;0.0;3.0;3
349;transform;6;0;6;0;4.24;3.0;6
350;useful;5;1;6;1;2.83;3.0;5
351;role;4;2;6;2;1.41;3.0;4
352;citation;6;0;6;0;4.24;3.0;6
353;ampk;6;0;6;0;4.24;3.0;6
354;screen;5;1;6;1;2.83;3.0;5
355;injury;5;1;6;1;2.83;3.0;5
356;browser;2;4;6;2;1.41;3.0;4
357;identification;6;0;6;0;4.24;3.0;6
358;presence;6;0;6;0;4.24;3.0;6
359;purpose;5;1;6;1;2.83;3.0;5
360;participant;6;0;6;0;4.24;3.0;6
361;dynamic;6;0;6;0;4.24;3.0;6
362;feature;4;2;6;2;1.41;3.0;4
363;especially;5;1;6;1;2.83;3.0;5
364;rcts;6;0;6;0;4.24;3.0;6
365;aml12;6;0;6;0;4.24;3.0;6
366;sequence;2;4;6;2;1.41;3.0;4
367;have;6;0;6;0;4.24;3.0;6
368;visit;2;4;6;2;1.41;3.0;4
369;bayesian;6;0;6;0;4.24;3.0;6
370;parse;3;3;6;3;0.0;3.0;3
371;mass;3;3;6;3;0.0;3.0;3
372;bilingual;4;2;6;2;1.41;3.0;4
373;adt;6;0;6;0;4.24;3.0;6
374;add;6;0;6;0;4.24;3.0;6
375;gekid;6;0;6;0;4.24;3.0;6
376;way;4;1;5;1;2.12;2.5;4
377;markov;5;0;5;0;3.54;2.5;5
378;transmission;5;0;5;0;3.54;2.5;5
379;chemotherapy;0;5;5;0;3.54;2.5;5
380;reliable;3;2;5;2;0.71;2.5;3
381;regimen;0;5;5;0;3.54;2.5;5
382;cherenkov;5;0;5;0;3.54;2.5;5
383;principle;1;4;5;1;2.12;2.5;4
384;critical;5;0;5;0;3.54;2.5;5
385;programme;3;2;5;2;0.71;2.5;3
386;interface;5;0;5;0;3.54;2.5;5
387;journal;5;0;5;0;3.54;2.5;5
388;measurement;5;0;5;0;3.54;2.5;5
389;protective;2;3;5;2;0.71;2.5;3
390;selection;5;0;5;0;3.54;2.5;5
391;magicpl;5;0;5;0;3.54;2.5;5
392;2021;3;2;5;2;0.71;2.5;3
393;task;4;1;5;1;2.12;2.5;4
394;approve;4;1;5;1;2.12;2.5;4
395;smart;5;0;5;0;3.54;2.5;5
396;entry;4;1;5;1;2.12;2.5;4
397;excitation;5;0;5;0;3.54;2.5;5
398;requirement;5;0;5;0;3.54;2.5;5
399;world;5;0;5;0;3.54;2.5;5
400;convert;4;1;5;1;2.12;2.5;4
401;wide;4;1;5;1;2.12;2.5;4
402;qr;5;0;5;0;3.54;2.5;5
403;robust;5;0;5;0;3.54;2.5;5
404;lack;3;2;5;2;0.71;2.5;3
405;crc;5;0;5;0;3.54;2.5;5
406;hive;5;0;5;0;3.54;2.5;5
407;spark;5;0;5;0;3.54;2.5;5
408;key;5;0;5;0;3.54;2.5;5
409;traditional;4;1;5;1;2.12;2.5;4
410;major;4;1;5;1;2.12;2.5;4
411;tropicalis;5;0;5;0;3.54;2.5;5
412;activity;5;0;5;0;3.54;2.5;5
413;positive;3;2;5;2;0.71;2.5;3
414;easily;5;0;5;0;3.54;2.5;5
415;develop;4;1;5;1;2.12;2.5;4
416;metabolic;5;0;5;0;3.54;2.5;5
417;december;5;0;5;0;3.54;2.5;5
418;impact;5;0;5;0;3.54;2.5;5
419;description;4;1;5;1;2.12;2.5;4
420;jats;5;0;5;0;3.54;2.5;5
421;hfref;5;0;5;0;3.54;2.5;5
422;generation;3;2;5;2;0.71;2.5;3
423;addition;4;1;5;1;2.12;2.5;4
424;storage;5;0;5;0;3.54;2.5;5
425;interest;3;2;5;2;0.71;2.5;3
426;insight;5;0;5;0;3.54;2.5;5
427;niso;5;0;5;0;3.54;2.5;5
428;pgx;5;0;5;0;3.54;2.5;5
429;candidate;5;0;5;0;3.54;2.5;5
430;therapeutic;4;1;5;1;2.12;2.5;4
431;activate;5;0;5;0;3.54;2.5;5
432;block;4;1;5;1;2.12;2.5;4
433;szt;5;0;5;0;3.54;2.5;5
434;factor;5;0;5;0;3.54;2.5;5
435;raw;3;2;5;2;0.71;2.5;3
436;criterium;5;0;5;0;3.54;2.5;5
437;antiarrhythmic;5;0;5;0;3.54;2.5;5
438;20;5;0;5;0;3.54;2.5;5
439;behaviour;5;0;5;0;3.54;2.5;5
440;end;4;1;5;1;2.12;2.5;4
441;describe;4;1;5;1;2.12;2.5;4
442;represent;5;0;5;0;3.54;2.5;5
443;ho-1;5;0;5;0;3.54;2.5;5
444;adoption;5;0;5;0;3.54;2.5;5
445;ngsml;0;5;5;0;3.54;2.5;5
446;comprehensive;4;1;5;1;2.12;2.5;4
447;message;5;0;5;0;3.54;2.5;5
448;efficiency;4;1;5;1;2.12;2.5;4
449;category;5;0;5;0;3.54;2.5;5
450;digitize;5;0;5;0;3.54;2.5;5
451;autophagy;5;0;5;0;3.54;2.5;5
452;negative;4;1;5;1;2.12;2.5;4
453;automatically;3;2;5;2;0.71;2.5;3
454;indicate;3;2;5;2;0.71;2.5;3
455;organization;5;0;5;0;3.54;2.5;5
456;editor;5;0;5;0;3.54;2.5;5
457;oncology;5;0;5;0;3.54;2.5;5
458;optimize;4;1;5;1;2.12;2.5;4
459;german;2;3;5;2;0.71;2.5;3
460;product;5;0;5;0;3.54;2.5;5
461;call;5;0;5;0;3.54;2.5;5
462;previous;5;0;5;0;3.54;2.5;5
463;annotator;0;5;5;0;3.54;2.5;5
464;cross;3;2;5;2;0.71;2.5;3
465;machine;3;2;5;2;0.71;2.5;3
466;histogram;4;1;5;1;2.12;2.5;4
467;toolkit;2;3;5;2;0.71;2.5;3
468;run;4;1;5;1;2.12;2.5;4
469;infrastructure;5;0;5;0;3.54;2.5;5
470;mmms;5;0;5;0;3.54;2.5;5
471;english;3;2;5;2;0.71;2.5;3
472;advance;4;1;5;1;2.12;2.5;4
473;combination;3;2;5;2;0.71;2.5;3
474;xinmailong;4;1;5;1;2.12;2.5;4
475;nchs;5;0;5;0;3.54;2.5;5
476;instrument;1;4;5;1;2.12;2.5;4
477;guideline;5;0;5;0;3.54;2.5;5
478;ecrf;5;0;5;0;3.54;2.5;5
479;<;5;0;5;0;3.54;2.5;5
480;digital;4;0;4;0;2.83;2.0;4
481;prognosis;4;0;4;0;2.83;2.0;4
482;letter;4;0;4;0;2.83;2.0;4
483;inflammation;1;3;4;1;1.41;2.0;3
484;direction;0;4;4;0;2.83;2.0;4
485;adult;4;0;4;0;2.83;2.0;4
486;c.;4;0;4;0;2.83;2.0;4
487;benefit;4;0;4;0;2.83;2.0;4
488;correlation;4;0;4;0;2.83;2.0;4
489;tree;3;1;4;1;1.41;2.0;3
490;utilize;4;0;4;0;2.83;2.0;4
491;freely;2;2;4;2;0.0;2.0;2
492;policy;4;0;4;0;2.83;2.0;4
493;encode;4;0;4;0;2.83;2.0;4
494;xmh;4;0;4;0;2.83;2.0;4
495;xmm;4;0;4;0;2.83;2.0;4
496;0.0001;4;0;4;0;2.83;2.0;4
497;unique;3;1;4;1;1.41;2.0;3
498;improvement;2;2;4;2;0.0;2.0;2
499;production;3;1;4;1;1.41;2.0;3
500;engineer;4;0;4;0;2.83;2.0;4
501;reveal;2;2;4;2;0.0;2.0;2
502;chain;4;0;4;0;2.83;2.0;4
503;basic;2;2;4;2;0.0;2.0;2
504;vendor;4;0;4;0;2.83;2.0;4
505;genome;3;1;4;1;1.41;2.0;3
506;infiltration;4;0;4;0;2.83;2.0;4
507;prognostic;4;0;4;0;2.83;2.0;4
508;trend;4;0;4;0;2.83;2.0;4
509;cause;4;0;4;0;2.83;2.0;4
510;band;0;4;4;0;2.83;2.0;4
511;carcinoma;0;4;4;0;2.83;2.0;4
512;ijo;4;0;4;0;2.83;2.0;4
513;download;3;1;4;1;1.41;2.0;3
514;mapper;4;0;4;0;2.83;2.0;4
515;distribution;4;0;4;0;2.83;2.0;4
516;covid-19-related;4;0;4;0;2.83;2.0;4
517;practice;4;0;4;0;2.83;2.0;4
518;score;4;0;4;0;2.83;2.0;4
519;regular;0;4;4;0;2.83;2.0;4
520;fhir(r;4;0;4;0;2.83;2.0;4
521;author;4;0;4;0;2.83;2.0;4
522;receive;3;1;4;1;1.41;2.0;3
523;combine;3;1;4;1;1.41;2.0;3
524;aspect;4;0;4;0;2.83;2.0;4
525;mine;4;0;4;0;2.83;2.0;4
526;computer;3;1;4;1;1.41;2.0;3
527;concept;4;0;4;0;2.83;2.0;4
528;18;4;0;4;0;2.83;2.0;4
529;complete;4;0;4;0;2.83;2.0;4
530;strategy;4;0;4;0;2.83;2.0;4
531;genomic;4;0;4;0;2.83;2.0;4
532;mv;4;0;4;0;2.83;2.0;4
533;statcheck;4;0;4;0;2.83;2.0;4
534;november;3;1;4;1;1.41;2.0;3
535;hospital;2;2;4;2;0.0;2.0;2
536;early;4;0;4;0;2.83;2.0;4
537;alpha;3;1;4;1;1.41;2.0;3
538;knowledge;3;1;4;1;1.41;2.0;3
539;diagnosis;2;2;4;2;0.0;2.0;2
540;current;3;1;4;1;1.41;2.0;3
541;essential;4;0;4;0;2.83;2.0;4
542;effort;4;0;4;0;2.83;2.0;4
543;examine;4;0;4;0;2.83;2.0;4
544;closely;4;0;4;0;2.83;2.0;4
545;receptor;4;0;4;0;2.83;2.0;4
546;pharmacology;2;2;4;2;0.0;2.0;2
547;novel;3;1;4;1;1.41;2.0;3
548;necessary;3;1;4;1;1.41;2.0;3
549;node;4;0;4;0;2.83;2.0;4
550;word;0;4;4;0;2.83;2.0;4
551;meet;4;0;4;0;2.83;2.0;4
552;range;3;1;4;1;1.41;2.0;3
553;validate;4;0;4;0;2.83;2.0;4
554;address;3;1;4;1;1.41;2.0;3
555;decision;4;0;4;0;2.83;2.0;4
556;service;4;0;4;0;2.83;2.0;4
557;reduction;4;0;4;0;2.83;2.0;4
558;emerge;4;0;4;0;2.83;2.0;4
559;false;1;3;4;1;1.41;2.0;3
560;procedure;3;1;4;1;1.41;2.0;3
561;agency;4;0;4;0;2.83;2.0;4
562;regulatory;4;0;4;0;2.83;2.0;4
563;point;3;1;4;1;1.41;2.0;3
564;feedback;1;3;4;1;1.41;2.0;3
565;relative;4;0;4;0;2.83;2.0;4
566;great;3;1;4;1;1.41;2.0;3
567;detail;3;1;4;1;1.41;2.0;3
568;10;3;1;4;1;1.41;2.0;3
569;learn;0;4;4;0;2.83;2.0;4
570;assess;2;2;4;2;0.0;2.0;2
571;cardiotoxicity;4;0;4;0;2.83;2.0;4
572;collect;2;2;4;2;0.0;2.0;2
573;broad;1;3;4;1;1.41;2.0;3
574;correspond;4;0;4;0;2.83;2.0;4
575;difference;3;1;4;1;1.41;2.0;3
576;r5;4;0;4;0;2.83;2.0;4
577;spart;0;4;4;0;2.83;2.0;4
578;make;4;0;4;0;2.83;2.0;4
579;h9c2;4;0;4;0;2.83;2.0;4
580;6;4;0;4;0;2.83;2.0;4
581;metabolite;4;0;4;0;2.83;2.0;4
582;register;4;0;4;0;2.83;2.0;4
583;involve;4;0;4;0;2.83;2.0;4
584;adopt;4;0;4;0;2.83;2.0;4
585;miss;4;0;4;0;2.83;2.0;4
586;pmparser;4;0;4;0;2.83;2.0;4
587;experiment;4;0;4;0;2.83;2.0;4
588;ii;4;0;4;0;2.83;2.0;4
589;leave;4;0;4;0;2.83;2.0;4
590;apply;1;3;4;1;1.41;2.0;3
591;usability;1;3;4;1;1.41;2.0;3
592;surface;3;1;4;1;1.41;2.0;3
593;pmdb;4;0;4;0;2.83;2.0;4
594;flux;4;0;4;0;2.83;2.0;4
595;xm;4;0;4;0;2.83;2.0;4
596;visualization;0;4;4;0;2.83;2.0;4
597;verify;4;0;4;0;2.83;2.0;4
598;shex;4;0;4;0;2.83;2.0;4
599;kinetic;4;0;4;0;2.83;2.0;4
600;dehydrogenase;4;0;4;0;2.83;2.0;4
601;phylogenetic;4;0;4;0;2.83;2.0;4
602;concern;3;1;4;1;1.41;2.0;3
603;import;1;3;4;1;1.41;2.0;3
604;association;4;0;4;0;2.83;2.0;4
605;c;4;0;4;0;2.83;2.0;4
606;measure;2;2;4;2;0.0;2.0;2
607;acquisition;4;0;4;0;2.83;2.0;4
608;consider;4;0;4;0;2.83;2.0;4
609;python;3;1;4;1;1.41;2.0;3
610;goal;4;0;4;0;2.83;2.0;4
611;interoperable;4;0;4;0;2.83;2.0;4
612;inference;4;0;4;0;2.83;2.0;4
613;comparison;4;0;4;0;2.83;2.0;4
614;contingency;4;0;4;0;2.83;2.0;4
615;i.e.;4;0;4;0;2.83;2.0;4
616;fast;4;0;4;0;2.83;2.0;4
617;randomize;4;0;4;0;2.83;2.0;4
618;volume;3;1;4;1;1.41;2.0;3
619;automatic;4;0;4;0;2.83;2.0;4
620;verification;4;0;4;0;2.83;2.0;4
621;agnostic;3;0;3;0;2.12;1.5;3
622;unknown;3;0;3;0;2.12;1.5;3
623;2d;2;1;3;1;0.71;1.5;2
624;interact;2;1;3;1;0.71;1.5;2
625;acute;3;0;3;0;2.12;1.5;3
626;quantify;3;0;3;0;2.12;1.5;3
627;finding;2;1;3;1;0.71;1.5;2
628;0.43;3;0;3;0;2.12;1.5;3
629;ventricular;3;0;3;0;2.12;1.5;3
630;efficiently;2;1;3;1;0.71;1.5;2
631;st;3;0;3;0;2.12;1.5;3
632;resolution;1;2;3;1;0.71;1.5;2
633;minimize;3;0;3;0;2.12;1.5;3
634;previously;2;1;3;1;0.71;1.5;2
635;death;3;0;3;0;2.12;1.5;3
636;computerize;2;1;3;1;0.71;1.5;2
637;ppar;3;0;3;0;2.12;1.5;3
638;affect;3;0;3;0;2.12;1.5;3
639;accessible;3;0;3;0;2.12;1.5;3
640;differentiate;3;0;3;0;2.12;1.5;3
641;serve;2;1;3;1;0.71;1.5;2
642;cholesteatoma;3;0;3;0;2.12;1.5;3
643;genetic;3;0;3;0;2.12;1.5;3
644;seek;2;1;3;1;0.71;1.5;2
645;biomarker;3;0;3;0;2.12;1.5;3
646;introduce;3;0;3;0;2.12;1.5;3
647;flexible;3;0;3;0;2.12;1.5;3
648;sensitivity;3;0;3;0;2.12;1.5;3
649;furthermore;3;0;3;0;2.12;1.5;3
650;psychological;3;0;3;0;2.12;1.5;3
651;confidentiality;3;0;3;0;2.12;1.5;3
652;scintillation;3;0;3;0;2.12;1.5;3
653;architecture;3;0;3;0;2.12;1.5;3
654;radiation;3;0;3;0;2.12;1.5;3
655;flow;3;0;3;0;2.12;1.5;3
656;biology;2;1;3;1;0.71;1.5;2
657;title;2;1;3;1;0.71;1.5;2
658;separate;2;1;3;1;0.71;1.5;2
659;dictionary;0;3;3;0;2.12;1.5;3
660;integrate;3;0;3;0;2.12;1.5;3
661;select;2;1;3;1;0.71;1.5;2
662;sample;3;0;3;0;2.12;1.5;3
663;deep;3;0;3;0;2.12;1.5;3
664;indicator;3;0;3;0;2.12;1.5;3
665;peptide;3;0;3;0;2.12;1.5;3
666;mainly;1;2;3;1;0.71;1.5;2
667;self;3;0;3;0;2.12;1.5;3
668;threshold;3;0;3;0;2.12;1.5;3
669;appropriate;3;0;3;0;2.12;1.5;3
670;protocol;3;0;3;0;2.12;1.5;3
671;enzymatic;3;0;3;0;2.12;1.5;3
672;doxorubicin;3;0;3;0;2.12;1.5;3
673;landscape;1;2;3;1;0.71;1.5;2
674;seven;3;0;3;0;2.12;1.5;3
675;consensus;3;0;3;0;2.12;1.5;3
676;sm;3;0;3;0;2.12;1.5;3
677;microsoft;2;1;3;1;0.71;1.5;2
678;appointment;3;0;3;0;2.12;1.5;3
679;mzmlb;3;0;3;0;2.12;1.5;3
680;investigator;3;0;3;0;2.12;1.5;3
681;localization;1;2;3;1;0.71;1.5;2
682;gamma;3;0;3;0;2.12;1.5;3
683;normal;3;0;3;0;2.12;1.5;3
684;complexity;3;0;3;0;2.12;1.5;3
685;journey;3;0;3;0;2.12;1.5;3
686;difficult;3;0;3;0;2.12;1.5;3
687;brain;3;0;3;0;2.12;1.5;3
688;prioritize;3;0;3;0;2.12;1.5;3
689;assay;2;1;3;1;0.71;1.5;2
690;nma;3;0;3;0;2.12;1.5;3
691;kit;3;0;3;0;2.12;1.5;3
692;modulate;3;0;3;0;2.12;1.5;3
693;behavior;3;0;3;0;2.12;1.5;3
694;coronavirus;3;0;3;0;2.12;1.5;3
695;public;3;0;3;0;2.12;1.5;3
696;successful;3;0;3;0;2.12;1.5;3
697;apoptosis;2;1;3;1;0.71;1.5;2
698;stakeholder;3;0;3;0;2.12;1.5;3
699;peak;0;3;3;0;2.12;1.5;3
700;spectrometry;3;0;3;0;2.12;1.5;3
701;day;1;2;3;1;0.71;1.5;2
702;generate;3;0;3;0;2.12;1.5;3
703;comprise;2;1;3;1;0.71;1.5;2
704;context;3;0;3;0;2.12;1.5;3
705;attribute;3;0;3;0;2.12;1.5;3
706;read;3;0;3;0;2.12;1.5;3
707;extensive;1;2;3;1;0.71;1.5;2
708;understand;3;0;3;0;2.12;1.5;3
709;contribute;2;1;3;1;0.71;1.5;2
710;external;3;0;3;0;2.12;1.5;3
711;ejection;3;0;3;0;2.12;1.5;3
712;hrms;0;3;3;0;2.12;1.5;3
713;fraction;3;0;3;0;2.12;1.5;3
714;enhance;3;0;3;0;2.12;1.5;3
715;clinically;3;0;3;0;2.12;1.5;3
716;assignment;1;2;3;1;0.71;1.5;2
717;east;3;0;3;0;2.12;1.5;3
718;prevention;1;2;3;1;0.71;1.5;2
719;readable;3;0;3;0;2.12;1.5;3
720;json;3;0;3;0;2.12;1.5;3
721;popular;3;0;3;0;2.12;1.5;3
722;dmdscheme;3;0;3;0;2.12;1.5;3
723;decrease;2;1;3;1;0.71;1.5;2
724;lead;2;1;3;1;0.71;1.5;2
725;recompute;3;0;3;0;2.12;1.5;3
726;beast;3;0;3;0;2.12;1.5;3
727;=;3;0;3;0;2.12;1.5;3
728;specialty;3;0;3;0;2.12;1.5;3
729;wise;3;0;3;0;2.12;1.5;3
730;york;3;0;3;0;2.12;1.5;3
731;amp;3;0;3;0;2.12;1.5;3
732;functional;2;1;3;1;0.71;1.5;2
733;federate;3;0;3;0;2.12;1.5;3
734;alternative;1;2;3;1;0.71;1.5;2
735;signal;3;0;3;0;2.12;1.5;3
736;biomedical;3;0;3;0;2.12;1.5;3
737;collaboration;3;0;3;0;2.12;1.5;3
738;registration;3;0;3;0;2.12;1.5;3
739;mobility;0;3;3;0;2.12;1.5;3
740;semantic;3;0;3;0;2.12;1.5;3
741;local;2;1;3;1;0.71;1.5;2
742;problem;2;1;3;1;0.71;1.5;2
743;discovery;3;0;3;0;2.12;1.5;3
744;curve;3;0;3;0;2.12;1.5;3
745;continuous;1;2;3;1;0.71;1.5;2
746;multi;3;0;3;0;2.12;1.5;3
747;dimensional;1;2;3;1;0.71;1.5;2
748;recent;3;0;3;0;2.12;1.5;3
749;like;3;0;3;0;2.12;1.5;3
750;consortium;3;0;3;0;2.12;1.5;3
751;hl7(r;3;0;3;0;2.12;1.5;3
752;spectrum;3;0;3;0;2.12;1.5;3
753;compose;3;0;3;0;2.12;1.5;3
754;upload;3;0;3;0;2.12;1.5;3
755;independent;3;0;3;0;2.12;1.5;3
756;lncrnas;3;0;3;0;2.12;1.5;3
757;systematic;3;0;3;0;2.12;1.5;3
758;mutation;2;1;3;1;0.71;1.5;2
759;central;2;1;3;1;0.71;1.5;2
760;capable;3;0;3;0;2.12;1.5;3
761;biochemical;2;1;3;1;0.71;1.5;2
762;relationship;3;0;3;0;2.12;1.5;3
763;retrieval;3;0;3;0;2.12;1.5;3
764;area;3;0;3;0;2.12;1.5;3
765;cover;2;1;3;1;0.71;1.5;2
766;science;2;1;3;1;0.71;1.5;2
767;million;3;0;3;0;2.12;1.5;3
768;well;3;0;3;0;2.12;1.5;3
769;index;1;2;3;1;0.71;1.5;2
770;store;2;1;3;1;0.71;1.5;2
771;potentially;3;0;3;0;2.12;1.5;3
772;display;2;1;3;1;0.71;1.5;2
773;track;3;0;3;0;2.12;1.5;3
774;remain;3;0;3;0;2.12;1.5;3
775;contribution;3;0;3;0;2.12;1.5;3
776;order;2;1;3;1;0.71;1.5;2
777;prescription;3;0;3;0;2.12;1.5;3
778;institute;2;1;3;1;0.71;1.5;2
779;international;3;0;3;0;2.12;1.5;3
780;date;3;0;3;0;2.12;1.5;3
781;dose;2;1;3;1;0.71;1.5;2
782;mix;1;2;3;1;0.71;1.5;2
783;relatively;2;1;3;1;0.71;1.5;2
784;metabolomics;3;0;3;0;2.12;1.5;3
785;skin;3;0;3;0;2.12;1.5;3
786;qc;0;3;3;0;2.12;1.5;3
787;disorder;3;0;3;0;2.12;1.5;3
788;flag;0;3;3;0;2.12;1.5;3
789;urinalysis;3;0;3;0;2.12;1.5;3
790;baseline;3;0;3;0;2.12;1.5;3
791;iii;3;0;3;0;2.12;1.5;3
792;observe;3;0;3;0;2.12;1.5;3
793;dock;3;0;3;0;2.12;1.5;3
794;b;1;2;3;1;0.71;1.5;2
795;differential;2;1;3;1;0.71;1.5;2
796;low;2;1;3;1;0.71;1.5;2
797;insertion;3;0;3;0;2.12;1.5;3
798;explore;2;1;3;1;0.71;1.5;2
799;computational;3;0;3;0;2.12;1.5;3
800;multilevel;3;0;3;0;2.12;1.5;3
801;regression;3;0;3;0;2.12;1.5;3
802;mzml;3;0;3;0;2.12;1.5;3
803;hierarchical;3;0;3;0;2.12;1.5;3
804;putative;1;2;3;1;0.71;1.5;2
805;widely;3;0;3;0;2.12;1.5;3
806;change;2;1;3;1;0.71;1.5;2
807;abstract;2;1;3;1;0.71;1.5;2
808;atla;3;0;3;0;2.12;1.5;3
809;translational;3;0;3;0;2.12;1.5;3
810;match;3;0;3;0;2.12;1.5;3
811;smack;0;3;3;0;2.12;1.5;3
812;enzyme;3;0;3;0;2.12;1.5;3
813;phthalocyanine;3;0;3;0;2.12;1.5;3
814;xylose;3;0;3;0;2.12;1.5;3
815;modern;2;1;3;1;0.71;1.5;2
816;g;3;0;3;0;2.12;1.5;3
817;rich;2;1;3;1;0.71;1.5;2
818;fpga;3;0;3;0;2.12;1.5;3
819;rt;3;0;3;0;2.12;1.5;3
820;atp;3;0;3;0;2.12;1.5;3
821;embed;3;0;3;0;2.12;1.5;3
822;aluminum;3;0;3;0;2.12;1.5;3
823;l(-;3;0;3;0;2.12;1.5;3
824;link;2;1;3;1;0.71;1.5;2
825;conversion;2;1;3;1;0.71;1.5;2
826;mediate;1;2;3;1;0.71;1.5;2
827;spectrometer;0;3;3;0;2.12;1.5;3
828;diagnostics;2;1;3;1;0.71;1.5;2
829;generic;2;1;3;1;0.71;1.5;2
830;mrna;3;0;3;0;2.12;1.5;3
831;h;3;0;3;0;2.12;1.5;3
832;lopdf;3;0;3;0;2.12;1.5;3
833;validity;2;0;2;0;1.41;1.0;2
834;strain;2;0;2;0;1.41;1.0;2
835;infer;0;2;2;0;1.41;1.0;2
836;currently;2;0;2;0;1.41;1.0;2
837;positional;2;0;2;0;1.41;1.0;2
838;throughput;1;1;2;1;0.0;1.0;1
839;carrier;0;2;2;0;1.41;1.0;2
840;hub;2;0;2;0;1.41;1.0;2
841;explode;2;0;2;0;1.41;1.0;2
842;commercially;2;0;2;0;1.41;1.0;2
843;2017;2;0;2;0;1.41;1.0;2
844;render;1;1;2;1;0.0;1.0;1
845;state;2;0;2;0;1.41;1.0;2
846;hdf5;2;0;2;0;1.41;1.0;2
847;proteomics;2;0;2;0;1.41;1.0;2
848;3;2;0;2;0;1.41;1.0;2
849;covidence.org;2;0;2;0;1.41;1.0;2
850;anisotropic;0;2;2;0;1.41;1.0;2
851;deserialization;2;0;2;0;1.41;1.0;2
852;catalog;2;0;2;0;1.41;1.0;2
853;acid;1;1;2;1;0.0;1.0;1
854;environmental;1;1;2;1;0.0;1.0;1
855;hapi;2;0;2;0;1.41;1.0;2
856;retrieve;1;1;2;1;0.0;1.0;1
857;semiconductor;0;2;2;0;1.41;1.0;2
858;provider;1;1;2;1;0.0;1.0;1
859;infection;2;0;2;0;1.41;1.0;2
860;r4;2;0;2;0;1.41;1.0;2
861;property;1;1;2;1;0.0;1.0;1
862;exclude;2;0;2;0;1.41;1.0;2
863;evolve;2;0;2;0;1.41;1.0;2
864;epidemic;2;0;2;0;1.41;1.0;2
865;loss;2;0;2;0;1.41;1.0;2
866;ready;1;1;2;1;0.0;1.0;1
867;equipment;1;1;2;1;0.0;1.0;1
868;characteristic;2;0;2;0;1.41;1.0;2
869;chromatographic;0;2;2;0;1.41;1.0;2
870;anatomic;2;0;2;0;1.41;1.0;2
871;observation;0;2;2;0;1.41;1.0;2
872;1995;2;0;2;0;1.41;1.0;2
873;browse;1;1;2;1;0.0;1.0;1
874;evolutionary;2;0;2;0;1.41;1.0;2
875;dedicate;0;2;2;0;1.41;1.0;2
876;def;2;0;2;0;1.41;1.0;2
877;eligibility;2;0;2;0;1.41;1.0;2
878;industrial;2;0;2;0;1.41;1.0;2
879;candida;2;0;2;0;1.41;1.0;2
880;translation;1;1;2;1;0.0;1.0;1
881;b3n2;0;2;2;0;1.41;1.0;2
882;proof;1;1;2;1;0.0;1.0;1
883;cov-2;2;0;2;0;1.41;1.0;2
884;sars;2;0;2;0;1.41;1.0;2
885;viral;2;0;2;0;1.41;1.0;2
886;randomization;2;0;2;0;1.41;1.0;2
887;e.g.;2;0;2;0;1.41;1.0;2
888;straightforward;1;1;2;1;0.0;1.0;1
889;allocation;1;1;2;1;0.0;1.0;1
890;student;2;0;2;0;1.41;1.0;2
891;rigorous;2;0;2;0;1.41;1.0;2
892;border;2;0;2;0;1.41;1.0;2
893;ring;0;2;2;0;1.41;1.0;2
894;preserve;1;1;2;1;0.0;1.0;1
895;eprescriptions;2;0;2;0;1.41;1.0;2
896;business;2;0;2;0;1.41;1.0;2
897;actor;2;0;2;0;1.41;1.0;2
898;quasi;2;0;2;0;1.41;1.0;2
899;>;2;0;2;0;1.41;1.0;2
900;consent;2;0;2;0;1.41;1.0;2
901;proprietary;2;0;2;0;1.41;1.0;2
902;300;2;0;2;0;1.41;1.0;2
903;laboratory;0;2;2;0;1.41;1.0;2
904;b4zg;2;0;2;0;1.41;1.0;2
905;limit;2;0;2;0;1.41;1.0;2
906;b6n2;0;2;2;0;1.41;1.0;2
907;severe;2;0;2;0;1.41;1.0;2
908;invitation;2;0;2;0;1.41;1.0;2
909;staff;0;2;2;0;1.41;1.0;2
910;line;0;2;2;0;1.41;1.0;2
911;table;1;1;2;1;0.0;1.0;1
912;liquor;2;0;2;0;1.41;1.0;2
913;precision;2;0;2;0;1.41;1.0;2
914;mother;2;0;2;0;1.41;1.0;2
915;transistor;0;2;2;0;1.41;1.0;2
916;board;2;0;2;0;1.41;1.0;2
917;powerful;2;0;2;0;1.41;1.0;2
918;personalize;2;0;2;0;1.41;1.0;2
919;calculation;0;2;2;0;1.41;1.0;2
920;cbioportal;2;0;2;0;1.41;1.0;2
921;nomenclature;1;1;2;1;0.0;1.0;1
922;snomed;2;0;2;0;1.41;1.0;2
923;2019;2;0;2;0;1.41;1.0;2
924;compression;2;0;2;0;1.41;1.0;2
925;membered;0;2;2;0;1.41;1.0;2
926;xzx;2;0;2;0;1.41;1.0;2
927;bibliometric;0;2;2;0;1.41;1.0;2
928;drive;2;0;2;0;1.41;1.0;2
929;y;0;2;2;0;1.41;1.0;2
930;pneumonia;2;0;2;0;1.41;1.0;2
931;shi;2;0;2;0;1.41;1.0;2
932;chronic;2;0;2;0;1.41;1.0;2
933;rescreening;2;0;2;0;1.41;1.0;2
934;pkc;0;2;2;0;1.41;1.0;2
935;southern;2;0;2;0;1.41;1.0;2
936;african;2;0;2;0;1.41;1.0;2
937;annotate;0;2;2;0;1.41;1.0;2
938;want;2;0;2;0;1.41;1.0;2
939;communicate;2;0;2;0;1.41;1.0;2
940;collation;2;0;2;0;1.41;1.0;2
941;deal;1;1;2;1;0.0;1.0;1
942;intend;0;2;2;0;1.41;1.0;2
943;establishment;1;1;2;1;0.0;1.0;1
944;api;2;0;2;0;1.41;1.0;2
945;java;2;0;2;0;1.41;1.0;2
946;protection;2;0;2;0;1.41;1.0;2
947;odk;2;0;2;0;1.41;1.0;2
948;epi;2;0;2;0;1.41;1.0;2
949;6-phosphate;2;0;2;0;1.41;1.0;2
950;pipeline;2;0;2;0;1.41;1.0;2
951;fit;2;0;2;0;1.41;1.0;2
952;bridge;1;1;2;1;0.0;1.0;1
953;advantage;2;0;2;0;1.41;1.0;2
954;pla2;0;2;2;0;1.41;1.0;2
955;consideration;2;0;2;0;1.41;1.0;2
956;encourage;2;0;2;0;1.41;1.0;2
957;density;2;0;2;0;1.41;1.0;2
958;topic;0;2;2;0;1.41;1.0;2
959;script;1;1;2;1;0.0;1.0;1
960;likelihood;2;0;2;0;1.41;1.0;2
961;visual;2;0;2;0;1.41;1.0;2
962;1d;2;0;2;0;1.41;1.0;2
963;ho-1-mediated;2;0;2;0;1.41;1.0;2
964;protect;2;0;2;0;1.41;1.0;2
965;ehr;2;0;2;0;1.41;1.0;2
966;view;0;2;2;0;1.41;1.0;2
967;preservation;2;0;2;0;1.41;1.0;2
968;accurately;1;1;2;1;0.0;1.0;1
969;fluorophore;2;0;2;0;1.41;1.0;2
970;visitor;0;2;2;0;1.41;1.0;2
971;overlap;2;0;2;0;1.41;1.0;2
972;probe;2;0;2;0;1.41;1.0;2
973;constraint;2;0;2;0;1.41;1.0;2
974;fluorescein;2;0;2;0;1.41;1.0;2
975;substantial;2;0;2;0;1.41;1.0;2
976;genomics;2;0;2;0;1.41;1.0;2
977;interview;0;2;2;0;1.41;1.0;2
978;exploit;2;0;2;0;1.41;1.0;2
979;dependency;1;1;2;1;0.0;1.0;1
980;ratio;2;0;2;0;1.41;1.0;2
981;consume;1;1;2;1;0.0;1.0;1
982;statistic;0;2;2;0;1.41;1.0;2
983;physician;0;2;2;0;1.41;1.0;2
984;qualitative;1;1;2;1;0.0;1.0;1
985;ultimately;1;1;2;1;0.0;1.0;1
986;nurse;0;2;2;0;1.41;1.0;2
987;rapidly;1;1;2;1;0.0;1.0;1
988;90;0;2;2;0;1.41;1.0;2
989;respective;1;1;2;1;0.0;1.0;1
990;location;2;0;2;0;1.41;1.0;2
991;license;2;0;2;0;1.41;1.0;2
992;grow;1;1;2;1;0.0;1.0;1
993;estimation;2;0;2;0;1.41;1.0;2
994;demand;1;1;2;1;0.0;1.0;1
995;save;1;1;2;1;0.0;1.0;1
996;accurate;1;1;2;1;0.0;1.0;1
997;covarion;2;0;2;0;1.41;1.0;2
998;functionality;2;0;2;0;1.41;1.0;2
999;beagle;2;0;2;0;1.41;1.0;2
1000;manner;1;1;2;1;0.0;1.0;1
1001;primary;2;0;2;0;1.41;1.0;2
1002;outcome;2;0;2;0;1.41;1.0;2
1003;80;1;1;2;1;0.0;1.0;1
1004;scientometric;2;0;2;0;1.41;1.0;2
1005;pinnacle;2;0;2;0;1.41;1.0;2
1006;character;2;0;2;0;1.41;1.0;2
1007;vdr;2;0;2;0;1.41;1.0;2
1008;indian;2;0;2;0;1.41;1.0;2
1009;rxra;2;0;2;0;1.41;1.0;2
1010;pandemic;2;0;2;0;1.41;1.0;2
1011;neural;2;0;2;0;1.41;1.0;2
1012;ca2;2;0;2;0;1.41;1.0;2
1013;assumption;1;1;2;1;0.0;1.0;1
1014;157;2;0;2;0;1.41;1.0;2
1015;april;2;0;2;0;1.41;1.0;2
1016;prefer;2;0;2;0;1.41;1.0;2
1017;rule;2;0;2;0;1.41;1.0;2
1018;unstructured;1;1;2;1;0.0;1.0;1
1019;initiative;2;0;2;0;1.41;1.0;2
1020;priority;2;0;2;0;1.41;1.0;2
1021;21;2;0;2;0;1.41;1.0;2
1022;quickly;2;0;2;0;1.41;1.0;2
1023;define;1;1;2;1;0.0;1.0;1
1024;incorporate;2;0;2;0;1.41;1.0;2
1025;zhen;2;0;2;0;1.41;1.0;2
1026;tea;2;0;2;0;1.41;1.0;2
1027;template;2;0;2;0;1.41;1.0;2
1028;enter;2;0;2;0;1.41;1.0;2
1029;co;2;0;2;0;1.41;1.0;2
1030;achieve;2;0;2;0;1.41;1.0;2
1031;valuable;2;0;2;0;1.41;1.0;2
1032;satisfy;1;1;2;1;0.0;1.0;1
1033;22;0;2;2;0;1.41;1.0;2
1034;reuse;2;0;2;0;1.41;1.0;2
1035;silico;2;0;2;0;1.41;1.0;2
1036;email;1;1;2;1;0.0;1.0;1
1037;informatics;2;0;2;0;1.41;1.0;2
1038;51;2;0;2;0;1.41;1.0;2
1039;simulator;2;0;2;0;1.41;1.0;2
1040;foundation;2;0;2;0;1.41;1.0;2
1041;disqualify;2;0;2;0;1.41;1.0;2
1042;medium;0;2;2;0;1.41;1.0;2
1043;heterogeneity;2;0;2;0;1.41;1.0;2
1044;ros;0;2;2;0;1.41;1.0;2
1045;investigation;0;2;2;0;1.41;1.0;2
1046;month;1;1;2;1;0.0;1.0;1
1047;interchange;2;0;2;0;1.41;1.0;2
1048;medication;1;1;2;1;0.0;1.0;1
1049;pattern;2;0;2;0;1.41;1.0;2
1050;150;2;0;2;0;1.41;1.0;2
1051;ngsmleditor;0;2;2;0;1.41;1.0;2
1052;psychotherapy;2;0;2;0;1.41;1.0;2
1053;multilingual;0;2;2;0;1.41;1.0;2
1054;monolayer;0;2;2;0;1.41;1.0;2
1055;period;2;0;2;0;1.41;1.0;2
1056;accommodate;1;1;2;1;0.0;1.0;1
1057;society;2;0;2;0;1.41;1.0;2
1058;photo;2;0;2;0;1.41;1.0;2
1059;random;2;0;2;0;1.41;1.0;2
1060;solid;2;0;2;0;1.41;1.0;2
1061;ophthalmic;2;0;2;0;1.41;1.0;2
1062;heading;0;2;2;0;1.41;1.0;2
1063;nlm;0;2;2;0;1.41;1.0;2
1064;recist;2;0;2;0;1.41;1.0;2
1065;editorial;2;0;2;0;1.41;1.0;2
1066;commentary;2;0;2;0;1.41;1.0;2
1067;conformance;2;0;2;0;1.41;1.0;2
1068;excel;1;1;2;1;0.0;1.0;1
1069;maintain;1;1;2;1;0.0;1.0;1
1070;pharmacogenomics;2;0;2;0;1.41;1.0;2
1071;triage;2;0;2;0;1.41;1.0;2
1072;long;2;0;2;0;1.41;1.0;2
1073;distribute;2;0;2;0;1.41;1.0;2
1074;desire;2;0;2;0;1.41;1.0;2
1075;degree;2;0;2;0;1.41;1.0;2
1076;cognitive;2;0;2;0;1.41;1.0;2
1077;na(+)-k(+)-atpase;2;0;2;0;1.41;1.0;2
1078;ca(2+)-mg(2+)-atpase;2;0;2;0;1.41;1.0;2
1079;consistency;2;0;2;0;1.41;1.0;2
1080;sdh;2;0;2;0;1.41;1.0;2
1081;n;1;1;2;1;0.0;1.0;1
1082;analytic;1;1;2;1;0.0;1.0;1
1083;influence;2;0;2;0;1.41;1.0;2
1084;cochrane;2;0;2;0;1.41;1.0;2
1085;face;2;0;2;0;1.41;1.0;2
1086;harmonize;2;0;2;0;1.41;1.0;2
1087;adt2fhir;2;0;2;0;1.41;1.0;2
1088;sirt1;2;0;2;0;1.41;1.0;2
1089;bias;2;0;2;0;1.41;1.0;2
1090;accord;1;1;2;1;0.0;1.0;1
1091;stratification;2;0;2;0;1.41;1.0;2
1092;manual;2;0;2;0;1.41;1.0;2
1093;oncological;2;0;2;0;1.41;1.0;2
1094;biosynthesis;2;0;2;0;1.41;1.0;2
1095;university;2;0;2;0;1.41;1.0;2
1096;americana;2;0;2;0;1.41;1.0;2
1097;periplaneta;2;0;2;0;1.41;1.0;2
1098;partner;2;0;2;0;1.41;1.0;2
1099;outpatient;2;0;2;0;1.41;1.0;2
1100;wait;2;0;2;0;1.41;1.0;2
1101;option;2;0;2;0;1.41;1.0;2
1102;scan;2;0;2;0;1.41;1.0;2
1103;yqfm;2;0;2;0;1.41;1.0;2
1104;old;2;0;2;0;1.41;1.0;2
1105;list;2;0;2;0;1.41;1.0;2
1106;cardiac;2;0;2;0;1.41;1.0;2
1107;classification;2;0;2;0;1.41;1.0;2
1108;textual;2;0;2;0;1.41;1.0;2
1109;specificity;1;1;2;1;0.0;1.0;1
1110;return;2;0;2;0;1.41;1.0;2
1111;accept;2;0;2;0;1.41;1.0;2
1112;natriuretic;2;0;2;0;1.41;1.0;2
1113;stain;2;0;2;0;1.41;1.0;2
1114;commonly;1;1;2;1;0.0;1.0;1
1115;section;2;0;2;0;1.41;1.0;2
1116;light;2;0;2;0;1.41;1.0;2
1117;transfer;1;1;2;1;0.0;1.0;1
1118;diameter;2;0;2;0;1.41;1.0;2
1119;load;2;0;2;0;1.41;1.0;2
1120;176;2;0;2;0;1.41;1.0;2
1121;february;2;0;2;0;1.41;1.0;2
1122;sucra;2;0;2;0;1.41;1.0;2
1123;enrich;2;0;2;0;1.41;1.0;2
1124;microenvironment;2;0;2;0;1.41;1.0;2
1125;utility;2;0;2;0;1.41;1.0;2
1126;outperform;2;0;2;0;1.41;1.0;2
1127;23;2;0;2;0;1.41;1.0;2
1128;independently;1;1;2;1;0.0;1.0;1
1129;predict;1;1;2;1;0.0;1.0;1
1130;express;2;0;2;0;1.41;1.0;2
1131;limitation;2;0;2;0;1.41;1.0;2
1132;3.3.2;2;0;2;0;1.41;1.0;2
1133;roc;2;0;2;0;1.41;1.0;2
1134;digitization;2;0;2;0;1.41;1.0;2
1135;experimental;2;0;2;0;1.41;1.0;2
1136;duration;2;0;2;0;1.41;1.0;2
1137;note;1;1;2;1;0.0;1.0;1
1138;average;1;1;2;1;0.0;1.0;1
1139;blind;2;0;2;0;1.41;1.0;2
1140;center;2;0;2;0;1.41;1.0;2
1141;rest;1;1;2;1;0.0;1.0;1
1142;derive;2;0;2;0;1.41;1.0;2
1143;tomography;2;0;2;0;1.41;1.0;2
1144;mitochondrion;2;0;2;0;1.41;1.0;2
1145;strenda;2;0;2;0;1.41;1.0;2
1146;constant;2;0;2;0;1.41;1.0;2
1147;interval;1;1;2;1;0.0;1.0;1
1148;estimate;2;0;2;0;1.41;1.0;2
1149;30;2;0;2;0;1.41;1.0;2
1150;shed;2;0;2;0;1.41;1.0;2
1151;colorectal;2;0;2;0;1.41;1.0;2
1152;condition;2;0;2;0;1.41;1.0;2
1153;reaction;2;0;2;0;1.41;1.0;2
1154;documentation;1;1;2;1;0.0;1.0;1
1155;ordpath;2;0;2;0;1.41;1.0;2
1156;memory;2;0;2;0;1.41;1.0;2
1157;vital;2;0;2;0;1.41;1.0;2
1158;certain;2;0;2;0;1.41;1.0;2
1159;bench;2;0;2;0;1.41;1.0;2
1160;ameliorate;2;0;2;0;1.41;1.0;2
1161;questionnaire;2;0;2;0;1.41;1.0;2
1162;serum;1;1;2;1;0.0;1.0;1
1163;segment;2;0;2;0;1.41;1.0;2
1164;alleviate;2;0;2;0;1.41;1.0;2
1165;keyword;1;1;2;1;0.0;1.0;1
1166;successfully;2;0;2;0;1.41;1.0;2
1167;sf;2;0;2;0;1.41;1.0;2
1168;construction;2;0;2;0;1.41;1.0;2
1169;beneficial;1;1;2;1;0.0;1.0;1
1170;marker;1;1;2;1;0.0;1.0;1
1171;creation;2;0;2;0;1.41;1.0;2
1172;outline;2;0;2;0;1.41;1.0;2
1173;n6-methyladenosine;2;0;2;0;1.41;1.0;2
1174;llc;2;0;2;0;1.41;1.0;2
1175;costly;2;0;2;0;1.41;1.0;2
1176;corpus;1;1;2;1;0.0;1.0;1
1177;inflammatory;2;0;2;0;1.41;1.0;2
1178;convenient;2;0;2;0;1.41;1.0;2
1179;week;2;0;2;0;1.41;1.0;2
1180;intervention;2;0;2;0;1.41;1.0;2
1181;inhibitor;2;0;2;0;1.41;1.0;2
1182;availability;2;0;2;0;1.41;1.0;2
1183;possibility;2;0;2;0;1.41;1.0;2
1184;survival;2;0;2;0;1.41;1.0;2
1185;finally;2;0;2;0;1.41;1.0;2
1186;modification;2;0;2;0;1.41;1.0;2
1187;minute;2;0;2;0;1.41;1.0;2
1188;extension;2;0;2;0;1.41;1.0;2
1189;lesion;2;0;2;0;1.41;1.0;2
1190;global;2;0;2;0;1.41;1.0;2
1191;bring;1;1;2;1;0.0;1.0;1
1192;take;1;1;2;1;0.0;1.0;1
1193;carry;2;0;2;0;1.41;1.0;2
1194;additional;2;0;2;0;1.41;1.0;2
1195;maintenance;1;1;2;1;0.0;1.0;1
1196;hq;2;0;2;0;1.41;1.0;2
1197;numerous;1;1;2;1;0.0;1.0;1
1198;problematic;2;0;2;0;1.41;1.0;2
1199;small;2;0;2;0;1.41;1.0;2
1200;book;2;0;2;0;1.41;1.0;2
1201;routine;2;0;2;0;1.41;1.0;2
1202;assign;2;0;2;0;1.41;1.0;2
1203;half;2;0;2;0;1.41;1.0;2
1204;construct;2;0;2;0;1.41;1.0;2
1205;obvious;1;1;2;1;0.0;1.0;1
1206;computable;2;0;2;0;1.41;1.0;2
1207;ny;2;0;2;0;1.41;1.0;2
1208;manage;2;0;2;0;1.41;1.0;2
1209;blot;2;0;2;0;1.41;1.0;2
1210;pdf;2;0;2;0;1.41;1.0;2
1211;scope;2;0;2;0;1.41;1.0;2
1212;pathological;1;1;2;1;0.0;1.0;1
1213;affordability;2;0;2;0;1.41;1.0;2
1214;rational;2;0;2;0;1.41;1.0;2
1215;position;2;0;2;0;1.41;1.0;2
1216;mitigate;2;0;2;0;1.41;1.0;2
1217;burden;2;0;2;0;1.41;1.0;2
1218;give;1;1;2;1;0.0;1.0;1
1219;elevation;2;0;2;0;1.41;1.0;2
1220;reason;2;0;2;0;1.41;1.0;2
1221;mouse;2;0;2;0;1.41;1.0;2
1222;usa;2;0;2;0;1.41;1.0;2
1223;fda;2;0;2;0;1.41;1.0;2
1224;act;2;0;2;0;1.41;1.0;2
1225;pa;2;0;2;0;1.41;1.0;2
1226;frequent;1;1;2;1;0.0;1.0;1
1227;lipopolysaccharide;2;0;2;0;1.41;1.0;2
1228;clinician;1;1;2;1;0.0;1.0;1
1229;repository;2;0;2;0;1.41;1.0;2
1230;clinic;2;0;2;0;1.41;1.0;2
1231;differ;2;0;2;0;1.41;1.0;2
1232;synthesis;2;0;2;0;1.41;1.0;2
1233;western;2;0;2;0;1.41;1.0;2
1234;diagnostic;2;0;2;0;1.41;1.0;2
1235;split;1;1;2;1;0.0;1.0;1
1236;manually;2;0;2;0;1.41;1.0;2
1237;physic;2;0;2;0;1.41;1.0;2
1238;statistically;2;0;2;0;1.41;1.0;2
1239;quantitative;2;0;2;0;1.41;1.0;2
1240;reverse;2;0;2;0;1.41;1.0;2
1241;transcription;2;0;2;0;1.41;1.0;2
1242;49;2;0;2;0;1.41;1.0;2
1243;xianmao;2;0;2;0;1.41;1.0;2
1244;experience;2;0;2;0;1.41;1.0;2
1245;identifier;2;0;2;0;1.41;1.0;2
1246;pmc;2;0;2;0;1.41;1.0;2
1247;initial;2;0;2;0;1.41;1.0;2
1248;respiratory;2;0;2;0;1.41;1.0;2
1249;play;2;0;2;0;1.41;1.0;2
1250;partially;1;1;2;1;0.0;1.0;1
1251;10.5281;1;0;1;0;0.71;0.5;1
1252;usual;1;0;1;0;0.71;0.5;1
1253;doi;1;0;1;0;0.71;0.5;1
1254;postgresql;1;0;1;0;0.71;0.5;1
1255;invalid;1;0;1;0;0.71;0.5;1
1256;assurance;1;0;1;0;0.71;0.5;1
1257;9,073;1;0;1;0;0.71;0.5;1
1258;eligible;1;0;1;0;0.71;0.5;1
1259;107;1;0;1;0;0.71;0.5;1
1260;plot;1;0;1;0;0.71;0.5;1
1261;invaluable;1;0;1;0;0.71;0.5;1
1262;inconvenient;1;0;1;0;0.71;0.5;1
1263;relational;1;0;1;0;0.71;0.5;1
1264;pmids;1;0;1;0;0.71;0.5;1
1265;regularly;1;0;1;0;0.71;0.5;1
1266;reproducible;1;0;1;0;0.71;0.5;1
1267;transparent;1;0;1;0;0.71;0.5;1
1268;gpl-2;1;0;1;0;0.71;0.5;1
1269;https://pmparser.hugheylab.org;1;0;1;0;0.71;0.5;1
1270;funnel;1;0;1;0;0.71;0.5;1
1271;systematize;1;0;1;0;0.71;0.5;1
1272;zenodo.4008109;1;0;1;0;0.71;0.5;1
1273;19670;1;0;1;0;0.71;0.5;1
1274;attract;1;0;1;0;0.71;0.5;1
1275;considerable;1;0;1;0;0.71;0.5;1
1276;attention;1;0;1;0;0.71;0.5;1
1277;outstanding;1;0;1;0;0.71;0.5;1
1278;multifaceted;1;0;1;0;0.71;0.5;1
1279;tsv;1;0;1;0;0.71;0.5;1
1280;immunohistochemistry;1;0;1;0;0.71;0.5;1
1281;45;1;0;1;0;0.71;0.5;1
1282;economic;1;0;1;0;0.71;0.5;1
1283;0;1;0;1;0;0.71;0.5;1
1284;/=;1;0;1;0;0.71;0.5;1
1285;heavy;1;0;1;0;0.71;0.5;1
1286;5520;1;0;1;0;0.71;0.5;1
1287;august;1;0;1;0;0.71;0.5;1
1288;membrane;1;0;1;0;0.71;0.5;1
1289;multistep;1;0;1;0;0.71;0.5;1
1290;332;1;0;1;0;0.71;0.5;1
1291;interestingly;1;0;1;0;0.71;0.5;1
1292;lymphoma;1;0;1;0;0.71;0.5;1
1293;safe;1;0;1;0;0.71;0.5;1
1294;proteomic;1;0;1;0;0.71;0.5;1
1295;rna;1;0;1;0;0.71;0.5;1
1296;seq;1;0;1;0;0.71;0.5;1
1297;anticancer;1;0;1;0;0.71;0.5;1
1298;therapeutics;1;0;1;0;0.71;0.5;1
1299;innovative;1;0;1;0;0.71;0.5;1
1300;inception;1;0;1;0;0.71;0.5;1
1301;logic;1;0;1;0;0.71;0.5;1
1302;google;1;0;1;0;0.71;0.5;1
1303;integrity;1;0;1;0;0.71;0.5;1
1304;bigquery;1;0;1;0;0.71;0.5;1
1305;https://console.cloud.google.com/bigquery?project=pmdb-bq&d=pmdb;1;0;1;0;0.71;0.5;1
1306;adjust;1;0;1;0;0.71;0.5;1
1307;primarily;1;0;1;0;0.71;0.5;1
1308;generally;1;0;1;0;0.71;0.5;1
1309;ignore;1;0;1;0;0.71;0.5;1
1310;standardization;1;0;1;0;0.71;0.5;1
1311;technical;1;0;1;0;0.71;0.5;1
1312;defs;1;0;1;0;0.71;0.5;1
1313;pathology;1;0;1;0;0.71;0.5;1
1314;contextual;1;0;1;0;0.71;0.5;1
1315;structural;1;0;1;0;0.71;0.5;1
1316;lifespan;1;0;1;0;0.71;0.5;1
1317;grouping;1;0;1;0;0.71;0.5;1
1318;registry;1;0;1;0;0.71;0.5;1
1319;rank;1;0;1;0;0.71;0.5;1
1320;cumulative;1;0;1;0;0.71;0.5;1
1321;regenerate;1;0;1;0;0.71;0.5;1
1322;synoptic;1;0;1;0;0.71;0.5;1
1323;intact;1;0;1;0;0.71;0.5;1
1324;able;1;0;1;0;0.71;0.5;1
1325;surveillance;1;0;1;0;0.71;0.5;1
1326;2197;1;0;1;0;0.71;0.5;1
1327;3rd;1;0;1;0;0.71;0.5;1
1328;aggregation;1;0;1;0;0.71;0.5;1
1329;permit;1;0;1;0;0.71;0.5;1
1330;huangqi;1;0;1;0;0.71;0.5;1
1331;warrant;1;0;1;0;0.71;0.5;1
1332;2693;1;0;1;0;0.71;0.5;1
1333;rk;1;0;1;0;0.71;0.5;1
1334;copasi;1;0;1;0;0.71;0.5;1
1335;sabio;1;0;1;0;0.71;0.5;1
1336;feasible;1;0;1;0;0.71;0.5;1
1337;difficulty;1;0;1;0;0.71;0.5;1
1338;timeliness;1;0;1;0;0.71;0.5;1
1339;checklist;1;0;1;0;0.71;0.5;1
1340;chart;1;0;1;0;0.71;0.5;1
1341;mutual;1;0;1;0;0.71;0.5;1
1342;generator;1;0;1;0;0.71;0.5;1
1343;coordinate;1;0;1;0;0.71;0.5;1
1344;incomplete;1;0;1;0;0.71;0.5;1
1345;android;1;0;1;0;0.71;0.5;1
1346;multichannel;1;0;1;0;0.71;0.5;1
1347;plasma;1;0;1;0;0.71;0.5;1
1348;chapter;1;0;1;0;0.71;0.5;1
1349;cooperation;1;0;1;0;0.71;0.5;1
1350;analyse;1;0;1;0;0.71;0.5;1
1351;understandable;1;0;1;0;0.71;0.5;1
1352;feasibility;1;0;1;0;0.71;0.5;1
1353;semantically;1;0;1;0;0.71;0.5;1
1354;seamless;1;0;1;0;0.71;0.5;1
1355;portal;1;0;1;0;0.71;0.5;1
1356;publisher;1;0;1;0;0.71;0.5;1
1357;lod;1;0;1;0;0.71;0.5;1
1358;crawl;1;0;1;0;0.71;0.5;1
1359;people;1;0;1;0;0.71;0.5;1
1360;spreadsheet;1;0;1;0;0.71;0.5;1
1361;complicate;1;0;1;0;0.71;0.5;1
1362;ask;1;0;1;0;0.71;0.5;1
1363;semi;1;0;1;0;0.71;0.5;1
1364;db;1;0;1;0;0.71;0.5;1
1365;get;1;0;1;0;0.71;0.5;1
1366;sector;1;0;1;0;0.71;0.5;1
1367;collate;1;0;1;0;0.71;0.5;1
1368;fair;1;0;1;0;0.71;0.5;1
1369;formulate;1;0;1;0;0.71;0.5;1
1370;37.51;1;0;1;0;0.71;0.5;1
1371;36.88;1;0;1;0;0.71;0.5;1
1372;40.04;1;0;1;0;0.71;0.5;1
1373;perfectly;1;0;1;0;0.71;0.5;1
1374;15842;1;0;1;0;0.71;0.5;1
1375;402;1;0;1;0;0.71;0.5;1
1376;hypothesis;1;0;1;0;0.71;0.5;1
1377;prone;1;0;1;0;0.71;0.5;1
1378;odd;1;0;1;0;0.71;0.5;1
1379;logarithm;1;0;1;0;0.71;0.5;1
1380;intention;1;0;1;0;0.71;0.5;1
1381;hdl;1;0;1;0;0.71;0.5;1
1382;emphasis;1;0;1;0;0.71;0.5;1
1383;28;1;0;1;0;0.71;0.5;1
1384;25.51;1;0;1;0;0.71;0.5;1
1385;2.13;1;0;1;0;0.71;0.5;1
1386;usable;1;0;1;0;0.71;0.5;1
1387;actively;1;0;1;0;0.71;0.5;1
1388;increasingly;1;0;1;0;0.71;0.5;1
1389;keep;1;0;1;0;0.71;0.5;1
1390;tight;1;0;1;0;0.71;0.5;1
1391;couple;1;0;1;0;0.71;0.5;1
1392;societal;1;0;1;0;0.71;0.5;1
1393;hardware;1;0;1;0;0.71;0.5;1
1394;modality;1;0;1;0;0.71;0.5;1
1395;95;1;0;1;0;0.71;0.5;1
1396;align;1;0;1;0;0.71;0.5;1
1397;relevance;1;0;1;0;0.71;0.5;1
1398;tedious;1;0;1;0;0.71;0.5;1
1399;2.80;1;0;1;0;0.71;0.5;1
1400;1.62;1;0;1;0;0.71;0.5;1
1401;ci;1;0;1;0;0.71;0.5;1
1402;sparql;1;0;1;0;0.71;0.5;1
1403;reusable;1;0;1;0;0.71;0.5;1
1404;effectiveness;1;0;1;0;0.71;0.5;1
1405;diastolic;1;0;1;0;0.71;0.5;1
1406;pro;1;0;1;0;0.71;0.5;1
1407;guide;1;0;1;0;0.71;0.5;1
1408;accordance;1;0;1;0;0.71;0.5;1
1409;6-min;1;0;1;0;0.71;0.5;1
1410;tabulation;1;0;1;0;0.71;0.5;1
1411;walk;1;0;1;0;0.71;0.5;1
1412;cdisc)-compliant;1;0;1;0;0.71;0.5;1
1413;diverse;1;0;1;0;0.71;0.5;1
1414;breakthrough;1;0;1;0;0.71;0.5;1
1415;unstandardized;1;0;1;0;0.71;0.5;1
1416;systolic;1;0;1;0;0.71;0.5;1
1417;stroke;1;0;1;0;0.71;0.5;1
1418;minnesota;1;0;1;0;0.71;0.5;1
1419;cardiomyopathy;1;0;1;0;0.71;0.5;1
1420;terminal;1;0;1;0;0.71;0.5;1
1421;conventional;1;0;1;0;0.71;0.5;1
1422;recovery;1;0;1;0;0.71;0.5;1
1423;sgm;1;0;1;0;0.71;0.5;1
1424;astragalus;1;0;1;0;0.71;0.5;1
1425;shenfu;1;0;1;0;0.71;0.5;1
1426;shex)-based;1;0;1;0;0.71;0.5;1
1427;shape;1;0;1;0;0.71;0.5;1
1428;shengmai;1;0;1;0;0.71;0.5;1
1429;hinder;1;0;1;0;0.71;0.5;1
1430;join;1;0;1;0;0.71;0.5;1
1431;lyophilized;1;0;1;0;0.71;0.5;1
1432;assure;1;0;1;0;0.71;0.5;1
1433;shenmai;1;0;1;0;0.71;0.5;1
1434;zero;1;0;1;0;0.71;0.5;1
1435;filter;1;0;1;0;0.71;0.5;1
1436;occur;1;0;1;0;0.71;0.5;1
1437;yiqifumai;1;0;1;0;0.71;0.5;1
1438;responsible;1;0;1;0;0.71;0.5;1
1439;suggest;1;0;1;0;0.71;0.5;1
1440;findable;1;0;1;0;0.71;0.5;1
1441;enzymology;1;0;1;0;0.71;0.5;1
1442;unclear;1;0;1;0;0.71;0.5;1
1443;china;1;0;1;0;0.71;0.5;1
1444;cockroach;1;0;1;0;0.71;0.5;1
1445;american;1;0;1;0;0.71;0.5;1
1446;bioactive;1;0;1;0;0.71;0.5;1
1447;biocatalysis;1;0;1;0;0.71;0.5;1
1448;course;1;0;1;0;0.71;0.5;1
1449;oxygenase-1;1;0;1;0;0.71;0.5;1
1450;substrate;1;0;1;0;0.71;0.5;1
1451;concentration;1;0;1;0;0.71;0.5;1
1452;initially;1;0;1;0;0.71;0.5;1
1453;phase;1;0;1;0;0.71;0.5;1
1454;container;1;0;1;0;0.71;0.5;1
1455;lesson;1;0;1;0;0.71;0.5;1
1456;heme;1;0;1;0;0.71;0.5;1
1457;ubiquitously;1;0;1;0;0.71;0.5;1
1458;sirna;1;0;1;0;0.71;0.5;1
1459;qualify;1;0;1;0;0.71;0.5;1
1460;znpp;1;0;1;0;0.71;0.5;1
1461;ho-1-specific;1;0;1;0;0.71;0.5;1
1462;importantly;1;0;1;0;0.71;0.5;1
1463;sod;1;0;1;0;0.71;0.5;1
1464;proliferation;1;0;1;0;0.71;0.5;1
1465;markedly;1;0;1;0;0.71;0.5;1
1466;optimal;1;0;1;0;0.71;0.5;1
1467;antioxidant;1;0;1;0;0.71;0.5;1
1468;involvement;1;0;1;0;0.71;0.5;1
1469;double;1;0;1;0;0.71;0.5;1
1470;lysosome;1;0;1;0;0.71;0.5;1
1471;upregulated;1;0;1;0;0.71;0.5;1
1472;protectively;1;0;1;0;0.71;0.5;1
1473;cardiovascular;1;0;1;0;0.71;0.5;1
1474;finish;1;0;1;0;0.71;0.5;1
1475;alignment;1;0;1;0;0.71;0.5;1
1476;amount;1;0;1;0;0.71;0.5;1
1477;smooth;0;1;1;0;0.71;0.5;1
1478;raas;0;1;1;0;0.71;0.5;1
1479;absorption;0;1;1;0;0.71;0.5;1
1480;fatty;0;1;1;0;0.71;0.5;1
1481;kegg;0;1;1;0;0.71;0.5;1
1482;explorer;1;0;1;0;0.71;0.5;1
1483;damage;0;1;1;0;0.71;0.5;1
1484;pretreatment;0;1;1;0;0.71;0.5;1
1485;ctnt;0;1;1;0;0.71;0.5;1
1486;abnormal;0;1;1;0;0.71;0.5;1
1487;administrate;0;1;1;0;0.71;0.5;1
1488;saline;0;1;1;0;0.71;0.5;1
1489;divide;0;1;1;0;0.71;0.5;1
1490;randomly;0;1;1;0;0.71;0.5;1
1491;cfda;0;1;1;0;0.71;0.5;1
1492;categorize;1;0;1;0;0.71;0.5;1
1493;vascular;0;1;1;0;0.71;0.5;1
1494;muscle;0;1;1;0;0.71;0.5;1
1495;education;1;0;1;0;0.71;0.5;1
1496;chemical;0;1;1;0;0.71;0.5;1
1497;gui;0;1;1;0;0.71;0.5;1
1498;friendly;0;1;1;0;0.71;0.5;1
1499;cost;0;1;1;0;0.71;0.5;1
1500;iran;1;0;1;0;0.71;0.5;1
1501;agent;0;1;1;0;0.71;0.5;1
1502;supplementary;0;1;1;0;0.71;0.5;1
1503;speculate;0;1;1;0;0.71;0.5;1
1504;exert;0;1;1;0;0.71;0.5;1
1505;regulate;0;1;1;0;0.71;0.5;1
1506;attenuation;0;1;1;0;0.71;0.5;1
1507;inhibition;0;1;1;0;0.71;0.5;1
1508;oxygen;0;1;1;0;0.71;0.5;1
1509;reactive;0;1;1;0;0.71;0.5;1
1510;mechanically;0;1;1;0;0.71;0.5;1
1511;ingredient;0;1;1;0;0.71;0.5;1
1512;ethic;1;0;1;0;0.71;0.5;1
1513;helpful;0;1;1;0;0.71;0.5;1
1514;edit;0;1;1;0;0.71;0.5;1
1515;administration;0;1;1;0;0.71;0.5;1
1516;question;0;1;1;0;0.71;0.5;1
1517;67/86;0;1;1;0;0.71;0.5;1
1518;78;0;1;1;0;0.71;0.5;1
1519;86;0;1;1;0;0.71;0.5;1
1520;suggestion;0;1;1;0;0.71;0.5;1
1521;look;0;1;1;0;0.71;0.5;1
1522;264/292;0;1;1;0;0.71;0.5;1
1523;reimbursement;1;0;1;0;0.71;0.5;1
1524;respondent;0;1;1;0;0.71;0.5;1
1525;224/292;0;1;1;0;0.71;0.5;1
1526;regulation;1;0;1;0;0.71;0.5;1
1527;answer;0;1;1;0;0.71;0.5;1
1528;292;0;1;1;0;0.71;0.5;1
1529;weekend;0;1;1;0;0.71;0.5;1
1530;fridays;0;1;1;0;0.71;0.5;1
1531;discover;0;1;1;0;0.71;0.5;1
1532;schedule;0;1;1;0;0.71;0.5;1
1533;expect;0;1;1;0;0.71;0.5;1
1534;depend;0;1;1;0;0.71;0.5;1
1535;massively;0;1;1;0;0.71;0.5;1
1536;-to-;1;0;1;0;0.71;0.5;1
1537;docker;0;1;1;0;0.71;0.5;1
1538;reflect;0;1;1;0;0.71;0.5;1
1539;bedside;1;0;1;0;0.71;0.5;1
1540;reconcile;0;1;1;0;0.71;0.5;1
1541;compliance;1;0;1;0;0.71;0.5;1
1542;phrase;0;1;1;0;0.71;0.5;1
1543;generalizable;0;1;1;0;0.71;0.5;1
1544;price;1;0;1;0;0.71;0.5;1
1545;sweden;0;1;1;0;0.71;0.5;1
1546;organizational;0;1;1;0;0.71;0.5;1
1547;comply;0;1;1;0;0.71;0.5;1
1548;workplace;0;1;1;0;0.71;0.5;1
1549;profession;0;1;1;0;0.71;0.5;1
1550;workshop;1;0;1;0;0.71;0.5;1
1551;unify;0;1;1;0;0.71;0.5;1
1552;drop;1;0;1;0;0.71;0.5;1
1553;7.5;0;1;1;0;0.71;0.5;1
1554;v(-1;0;1;1;0;0.71;0.5;1
1555;cm(2;0;1;1;0;0.71;0.5;1
1556;10(3;0;1;1;0;0.71;0.5;1
1557;0.6;0;1;1;0;0.71;0.5;1
1558;hole;0;1;1;0;0.71;0.5;1
1559;bilayer;0;1;1;0;0.71;0.5;1
1560;nature;0;1;1;0;0.71;0.5;1
1561;ev;0;1;1;0;0.71;0.5;1
1562;1.96;0;1;1;0;0.71;0.5;1
1563;pentagon;0;1;1;0;0.71;0.5;1
1564;uncertainty;1;0;1;0;0.71;0.5;1
1565;edge;0;1;1;0;0.71;0.5;1
1566;harness;1;0;1;0;0.71;0.5;1
1567;fragile;1;0;1;0;0.71;0.5;1
1568;pentagonal;0;1;1;0;0.71;0.5;1
1569;s(-1;0;1;1;0;0.71;0.5;1
1570;natural;0;1;1;0;0.71;0.5;1
1571;salient;1;0;1;0;0.71;0.5;1
1572;analytics;0;1;1;0;0.71;0.5;1
1573;reasonable;0;1;1;0;0.71;0.5;1
1574;completely;0;1;1;0;0.71;0.5;1
1575;pick;0;1;1;0;0.71;0.5;1
1576;comprehensible;0;1;1;0;0.71;0.5;1
1577;explain;0;1;1;0;0.71;0.5;1
1578;c++;0;1;1;0;0.71;0.5;1
1579;centroided;0;1;1;0;0.71;0.5;1
1580;z;0;1;1;0;0.71;0.5;1
1581;be;0;1;1;0;0.71;0.5;1
1582;r.;0;1;1;0;0.71;0.5;1
1583;hurdle;1;0;1;0;0.71;0.5;1
1584;overcome;1;0;1;0;0.71;0.5;1
1585;dimension;1;0;1;0;0.71;0.5;1
1586;sophisticate;0;1;1;0;0.71;0.5;1
1587;rationale;0;1;1;0;0.71;0.5;1
1588;scarce;1;0;1;0;0.71;0.5;1
1589;consist;0;1;1;0;0.71;0.5;1
1590;plain;0;1;1;0;0.71;0.5;1
1591;frontend;0;1;1;0;0.71;0.5;1
1592;searchable;0;1;1;0;0.71;0.5;1
1593;overtake;0;1;1;0;0.71;0.5;1
1594;med;0;1;1;0;0.71;0.5;1
1595;zb;0;1;1;0;0.71;0.5;1
1596;recently;0;1;1;0;0.71;0.5;1
1597;translate;0;1;1;0;0.71;0.5;1
1598;dimdi;0;1;1;0;0.71;0.5;1
1599;thesaurus;0;1;1;0;0.71;0.5;1
1600;rum;1;0;1;0;0.71;0.5;1
1601;strategic;1;0;1;0;0.71;0.5;1
1602;gpl;0;1;1;0;0.71;0.5;1
1603;gnu;0;1;1;0;0.71;0.5;1
1604;http://www.sysbio.org.cn/ngsml;0;1;1;0;0.71;0.5;1
1605;incompatibility;0;1;1;0;0.71;0.5;1
1606;solve;0;1;1;0;0.71;0.5;1
1607;modular;0;1;1;0;0.71;0.5;1
1608;switch;0;1;1;0;0.71;0.5;1
1609;ultraflat;0;1;1;0;0.71;0.5;1
1610;https://mesh-browser.de;0;1;1;0;0.71;0.5;1
1611;respect;1;0;1;0;0.71;0.5;1
1612;crystal;0;1;1;0;0.71;0.5;1
1613;b4n;0;1;1;0;0.71;0.5;1
1614;b3n;0;1;1;0;0.71;0.5;1
1615;stoichiometry;0;1;1;0;0.71;0.5;1
1616;stable;0;1;1;0;0.71;0.5;1
1617;thermodynamically;0;1;1;0;0.71;0.5;1
1618;desirable;0;1;1;0;0.71;0.5;1
1619;suitable;0;1;1;0;0.71;0.5;1
1620;lattice;0;1;1;0;0.71;0.5;1
1621;planar;0;1;1;0;0.71;0.5;1
1622;adopter;1;0;1;0;0.71;0.5;1
1623;prospect;1;0;1;0;0.71;0.5;1
1624;middle;1;0;1;0;0.71;0.5;1
1625;reconnaissance;1;0;1;0;0.71;0.5;1
1626;mondays;0;1;1;0;0.71;0.5;1
1627;place;0;1;1;0;0.71;0.5;1
1628;870;0;1;1;0;0.71;0.5;1
1629;systematically;1;0;1;0;0.71;0.5;1
1630;satisfaction;1;0;1;0;0.71;0.5;1
1631;marginal;1;0;1;0;0.71;0.5;1
1632;substantially;1;0;1;0;0.71;0.5;1
1633;queue;1;0;1;0;0.71;0.5;1
1634;evolution;1;0;1;0;0.71;0.5;1
1635;plastid;1;0;1;0;0.71;0.5;1
1636;bacterial;1;0;1;0;0.71;0.5;1
1637;mmm;1;0;1;0;0.71;0.5;1
1638;lineage;1;0;1;0;0.71;0.5;1
1639;vary;1;0;1;0;0.71;0.5;1
1640;qms;1;0;1;0;0.71;0.5;1
1641;emr;1;0;1;0;0.71;0.5;1
1642;variability;1;0;1;0;0.71;0.5;1
1643;selective;1;0;1;0;0.71;0.5;1
1644;variable;1;0;1;0;0.71;0.5;1
1645;generative;1;0;1;0;0.71;0.5;1
1646;effectively;1;0;1;0;0.71;0.5;1
1647;frequently;1;0;1;0;0.71;0.5;1
1648;rdb;1;0;1;0;0.71;0.5;1
1649;right;1;0;1;0;0.71;0.5;1
1650;31/1944;0;1;1;0;0.71;0.5;1
1651;1.7;0;1;1;0;0.71;0.5;1
1652;dblp;1;0;1;0;0.71;0.5;1
1653;newly;0;1;1;0;0.71;0.5;1
1654;collective;0;1;1;0;0.71;0.5;1
1655;assist;0;1;1;0;0.71;0.5;1
1656;fee;0;1;1;0;0.71;0.5;1
1657;interchangeable;0;1;1;0;0.71;0.5;1
1658;interactive;0;1;1;0;0.71;0.5;1
1659;distinct;0;1;1;0;0.71;0.5;1
1660;visualize;0;1;1;0;0.71;0.5;1
1661;listen;0;1;1;0;0.71;0.5;1
1662;phylogenetics;1;0;1;0;0.71;0.5;1
1663;heterotachy;1;0;1;0;0.71;0.5;1
1664;overlook;1;0;1;0;0.71;0.5;1
1665;uae;1;0;1;0;0.71;0.5;1
1666;2500;0;1;1;0;0.71;0.5;1
1667;netcdf4;1;0;1;0;0.71;0.5;1
1668;517;1;0;1;0;0.71;0.5;1
1669;implicitly;1;0;1;0;0.71;0.5;1
1670;valid;1;0;1;0;0.71;0.5;1
1671;uniquely;1;0;1;0;0.71;0.5;1
1672;comparable;1;0;1;0;0.71;0.5;1
1673;virtually;1;0;1;0;0.71;0.5;1
1674;stage;1;0;1;0;0.71;0.5;1
1675;uptake;1;0;1;0;0.71;0.5;1
1676;precise;1;0;1;0;0.71;0.5;1
1677;clear;1;0;1;0;0.71;0.5;1
1678;psi;1;0;1;0;0.71;0.5;1
1679;paramount;1;0;1;0;0.71;0.5;1
1680;14;1;0;1;0;0.71;0.5;1
1681;possess;1;0;1;0;0.71;0.5;1
1682;sheer;1;0;1;0;0.71;0.5;1
1683;adhere;1;0;1;0;0.71;0.5;1
1684;party;1;0;1;0;0.71;0.5;1
1685;january;1;0;1;0;0.71;0.5;1
1686;widespread;1;0;1;0;0.71;0.5;1
1687;homogeneous;1;0;1;0;0.71;0.5;1
1688;department;1;0;1;0;0.71;0.5;1
1689;simplify;1;0;1;0;0.71;0.5;1
1690;hold;1;0;1;0;0.71;0.5;1
1691;emirate;1;0;1;0;0.71;0.5;1
1692;phylogeny;1;0;1;0;0.71;0.5;1
1693;card;1;0;1;0;0.71;0.5;1
1694;emirati;1;0;1;0;0.71;0.5;1
1695;expatriate;1;0;1;0;0.71;0.5;1
1696;variation;1;0;1;0;0.71;0.5;1
1697;custom;1;0;1;0;0.71;0.5;1
1698;branch;1;0;1;0;0.71;0.5;1
1699;site-;1;0;1;0;0.71;0.5;1
1700;clarify;1;0;1;0;0.71;0.5;1
1701;proteowizard;1;0;1;0;0.71;0.5;1
1702;7.1;0;1;1;0;0.71;0.5;1
1703;138/1944;0;1;1;0;0.71;0.5;1
1704;presume;0;1;1;0;0.71;0.5;1
1705;3578;0;1;1;0;0.71;0.5;1
1706;lda;0;1;1;0;0.71;0.5;1
1707;dirichlet;0;1;1;0;0.71;0.5;1
1708;latent;0;1;1;0;0.71;0.5;1
1709;endure;1;0;1;0;0.71;0.5;1
1710;entire;0;1;1;0;0.71;0.5;1
1711;operation;1;0;1;0;0.71;0.5;1
1712;computation;1;0;1;0;0.71;0.5;1
1713;2000;0;1;1;0;0.71;0.5;1
1714;avoid;1;0;1;0;0.71;0.5;1
1715;crucial;1;0;1;0;0.71;0.5;1
1716;persistent;1;0;1;0;0.71;0.5;1
1717;merge;0;1;1;0;0.71;0.5;1
1718;lime;0;1;1;0;0.71;0.5;1
1719;adapt;0;1;1;0;0.71;0.5;1
1720;tr2;0;1;1;0;0.71;0.5;1
1721;hybridization;1;0;1;0;0.71;0.5;1
1722;flat;0;1;1;0;0.71;0.5;1
1723;discussion;0;1;1;0;0.71;0.5;1
1724;past;0;1;1;0;0.71;0.5;1
1725;webpage;0;1;1;0;0.71;0.5;1
1726;ahead;1;0;1;0;0.71;0.5;1
1727;spontaneous;0;1;1;0;0.71;0.5;1
1728;subjective;0;1;1;0;0.71;0.5;1
1729;compilation;0;1;1;0;0.71;0.5;1
1730;consolidate;1;0;1;0;0.71;0.5;1
1731;communication;1;0;1;0;0.71;0.5;1
1732;accelerate;1;0;1;0;0.71;0.5;1
1733;comer;1;0;1;0;0.71;0.5;1
1734;continue;0;1;1;0;0.71;0.5;1
1735;unmet;0;1;1;0;0.71;0.5;1
1736;huge;0;1;1;0;0.71;0.5;1
1737;recurrence;0;1;1;0;0.71;0.5;1
1738;mibi;0;1;1;0;0.71;0.5;1
1739;ultrasound;0;1;1;0;0.71;0.5;1
1740;ptp;0;1;1;0;0.71;0.5;1
1741;gmyc;0;1;1;0;0.71;0.5;1
1742;delineate;0;1;1;0;0.71;0.5;1
1743;abgd;0;1;1;0;0.71;0.5;1
1744;formalize;0;1;1;0;0.71;0.5;1
1745;parent;1;0;1;0;0.71;0.5;1
1746;delimit;0;1;1;0;0.71;0.5;1
1747;child;1;0;1;0;0.71;0.5;1
1748;ancestor;1;0;1;0;0.71;0.5;1
1749;versatile;0;1;1;0;0.71;0.5;1
1750;descendant;1;0;1;0;0.71;0.5;1
1751;proactive;0;1;1;0;0.71;0.5;1
1752;sibling;1;0;1;0;0.71;0.5;1
1753;encompass;0;1;1;0;0.71;0.5;1
1754;batch;0;1;1;0;0.71;0.5;1
1755;confirmation;0;1;1;0;0.71;0.5;1
1756;opiate;0;1;1;0;0.71;0.5;1
1757;dashboard;0;1;1;0;0.71;0.5;1
1758;customizable;0;1;1;0;0.71;0.5;1
1759;objectivity;0;1;1;0;0.71;0.5;1
1760;delimitation;0;1;1;0;0.71;0.5;1
1761;routinely;0;1;1;0;0.71;0.5;1
1762;syntax;0;1;1;0;0.71;0.5;1
1763;spart.xml;0;1;1;0;0.71;0.5;1
1764;matricial;0;1;1;0;0.71;0.5;1
1765;readability;0;1;1;0;0.71;0.5;1
1766;variant;0;1;1;0;0.71;0.5;1
1767;command;0;1;1;0;0.71;0.5;1
1768;optionally;0;1;1;0;0.71;0.5;1
1769;compatibility;0;1;1;0;0.71;0.5;1
1770;taxonomist;0;1;1;0;0.71;0.5;1
1771;obstacle;0;1;1;0;0.71;0.5;1
1772;excessively;0;1;1;0;0.71;0.5;1
1773;boundary;0;1;1;0;0.71;0.5;1
1774;robustness;0;1;1;0;0.71;0.5;1
1775;incongruences;0;1;1;0;0.71;0.5;1
1776;shortcoming;0;1;1;0;0.71;0.5;1
1777;2018;1;0;1;0;0.71;0.5;1
1778;overdose;1;0;1;0;0.71;0.5;1
1779;reusability;1;0;1;0;0.71;0.5;1
1780;july;1;0;1;0;0.71;0.5;1
1781;13.78;1;0;1;0;0.71;0.5;1
1782;140;1;0;1;0;0.71;0.5;1
1783;corneum;1;0;1;0;0.71;0.5;1
1784;nearly;1;0;1;0;0.71;0.5;1
1785;72.83;1;0;1;0;0.71;0.5;1
1786;740;1;0;1;0;0.71;0.5;1
1787;14.76;1;0;1;0;0.71;0.5;1
1788;2.3;1;0;1;0;0.71;0.5;1
1789;34.65;1;0;1;0;0.71;0.5;1
1790;352;1;0;1;0;0.71;0.5;1
1791;surgery;1;0;1;0;0.71;0.5;1
1792;refractive;1;0;1;0;0.71;0.5;1
1793;53.68;1;0;1;0;0.71;0.5;1
1794;124;1;0;1;0;0.71;0.5;1
1795;19.05;1;0;1;0;0.71;0.5;1
1796;trough;1;0;1;0;0.71;0.5;1
1797;crest;1;0;1;0;0.71;0.5;1
1798;coved;1;0;1;0;0.71;0.5;1
1799;contraindication;1;0;1;0;0.71;0.5;1
1800;intuitive;1;0;1;0;0.71;0.5;1
1801;entirely;1;0;1;0;0.71;0.5;1
1802;dynamical;1;0;1;0;0.71;0.5;1
1803;resonance;1;0;1;0;0.71;0.5;1
1804;mri;1;0;1;0;0.71;0.5;1
1805;govern;1;0;1;0;0.71;0.5;1
1806;characterize;1;0;1;0;0.71;0.5;1
1807;owe;1;0;1;0;0.71;0.5;1
1808;simulate;1;0;1;0;0.71;0.5;1
1809;poor;1;0;1;0;0.71;0.5;1
1810;situation;1;0;1;0;0.71;0.5;1
1811;rare;1;0;1;0;0.71;0.5;1
1812;inherit;1;0;1;0;0.71;0.5;1
1813;arrhythmic;1;0;1;0;0.71;0.5;1
1814;44;1;0;1;0;0.71;0.5;1
1815;sudden;1;0;1;0;0.71;0.5;1
1816;magnetic;1;0;1;0;0.71;0.5;1
1817;perspective;1;0;1;0;0.71;0.5;1
1818;43;1;0;1;0;0.71;0.5;1
1819;segregate;1;0;1;0;0.71;0.5;1
1820;13;1;0;1;0;0.71;0.5;1
1821;printout;1;0;1;0;0.71;0.5;1
1822;ecgscan;1;0;1;0;0.71;0.5;1
1823;3.4.0;1;0;1;0;0.71;0.5;1
1824;bibliographic;1;0;1;0;0.71;0.5;1
1825;retrospective;1;0;1;0;0.71;0.5;1
1826;bravo;1;0;1;0;0.71;0.5;1
1827;glasgow;1;0;1;0;0.71;0.5;1
1828;correlate;1;0;1;0;0.71;0.5;1
1829;0.96;1;0;1;0;0.71;0.5;1
1830;0.07;1;0;1;0;0.71;0.5;1
1831;r(2;1;0;1;0;0.71;0.5;1
1832;0.93;1;0;1;0;0.71;0.5;1
1833;series;1;0;1;0;0.71;0.5;1
1834;female;1;0;1;0;0.71;0.5;1
1835;guest;1;0;1;0;0.71;0.5;1
1836;comprehensively;1;0;1;0;0.71;0.5;1
1837;8.66;1;0;1;0;0.71;0.5;1
1838;12.99;1;0;1;0;0.71;0.5;1
1839;22.08;1;0;1;0;0.71;0.5;1
1840;35.49;1;0;1;0;0.71;0.5;1
1841;82;1;0;1;0;0.71;0.5;1
1842;231;1;0;1;0;0.71;0.5;1
1843;historical;1;0;1;0;0.71;0.5;1
1844;pointcounterpoint;1;0;1;0;0.71;0.5;1
1845;cohort;1;0;1;0;0.71;0.5;1
1846;india;1;0;1;0;0.71;0.5;1
1847;surgical;1;0;1;0;0.71;0.5;1
1848;essay;1;0;1;0;0.71;0.5;1
1849;hypothesize;1;0;1;0;0.71;0.5;1
1850;relevant;1;0;1;0;0.71;0.5;1
1851;noise;1;0;1;0;0.71;0.5;1
1852;style;1;0;1;0;0.71;0.5;1
1853;frontier;1;0;1;0;0.71;0.5;1
1854;strive;1;0;1;0;0.71;0.5;1
1855;cinahl;1;0;1;0;0.71;0.5;1
1856;clarivate;1;0;1;0;0.71;0.5;1
1857;embase;1;0;1;0;0.71;0.5;1
1858;manuscript;1;0;1;0;0.71;0.5;1
1859;unit;1;0;1;0;0.71;0.5;1
1860;77;1;0;1;0;0.71;0.5;1
1861;csv;1;0;1;0;0.71;0.5;1
1862;temporal;1;0;1;0;0.71;0.5;1
1863;comma;1;0;1;0;0.71;0.5;1
1864;endnote;1;0;1;0;0.71;0.5;1
1865;bone;1;0;1;0;0.71;0.5;1
1866;variety;1;0;1;0;0.71;0.5;1
1867;deduplicate;1;0;1;0;0.71;0.5;1
1868;2016;1;0;1;0;0.71;0.5;1
1869;presentation;1;0;1;0;0.71;0.5;1
1870;scopus;1;0;1;0;0.71;0.5;1
1871;proquest;1;0;1;0;0.71;0.5;1
1872;dissertation;1;0;1;0;0.71;0.5;1
1873;cope;1;0;1;0;0.71;0.5;1
1874;23,730;1;0;1;0;0.71;0.5;1
1875;excite;1;0;1;0;0.71;0.5;1
1876;plos;1;0;1;0;0.71;0.5;1
1877;replicate;1;0;1;0;0.71;0.5;1
1878;subscription;1;0;1;0;0.71;0.5;1
1879;pay;1;0;1;0;0.71;0.5;1
1880;recommend;1;0;1;0;0.71;0.5;1
1881;s;1;0;1;0;0.71;0.5;1
1882;permissive;1;0;1;0;0.71;0.5;1
1883;two-;1;0;1;0;0.71;0.5;1
1884;side;1;0;1;0;0.71;0.5;1
1885;hour;1;0;1;0;0.71;0.5;1
1886;completeness;1;0;1;0;0.71;0.5;1
1887;lens;1;0;1;0;0.71;0.5;1
1888;pre;1;0;1;0;0.71;0.5;1
1889;simultaneously;1;0;1;0;0.71;0.5;1
1890;delay;1;0;1;0;0.71;0.5;1
1891;operatively;1;0;1;0;0.71;0.5;1
1892;far;1;0;1;0;0.71;0.5;1
1893;neighbour;1;0;1;0;0.71;0.5;1
1894;p=0.036;1;0;1;0;0.71;0.5;1
1895;p=0.006;1;0;1;0;0.71;0.5;1
1896;p=0.043;1;0;1;0;0.71;0.5;1
1897;geometric;1;0;1;0;0.71;0.5;1
1898;auc)=0.638;1;0;1;0;0.71;0.5;1
1899;virtual;1;0;1;0;0.71;0.5;1
1900;42.55;1;0;1;0;0.71;0.5;1
1901;86.50;1;0;1;0;0.71;0.5;1
1902;pass;1;0;1;0;0.71;0.5;1
1903;immediate;1;0;1;0;0.71;0.5;1
1904;56.10;1;0;1;0;0.71;0.5;1
1905;synaptic;1;0;1;0;0.71;0.5;1
1906;post;1;0;1;0;0.71;0.5;1
1907;median;1;0;1;0;0.71;0.5;1
1908;nuanced;1;0;1;0;0.71;0.5;1
1909;confer;1;0;1;0;0.71;0.5;1
1910;microscopic;1;0;1;0;0.71;0.5;1
1911;age;1;0;1;0;0.71;0.5;1
1912;37.10+/-17.27;1;0;1;0;0.71;0.5;1
1913;36.72+/-16.08;1;0;1;0;0.71;0.5;1
1914;interconnect;1;0;1;0;0.71;0.5;1
1915;number;1;0;1;0;0.71;0.5;1
1916;minimise;1;0;1;0;0.71;0.5;1
1917;mesoscopic;1;0;1;0;0.71;0.5;1
1918;46.75;1;0;1;0;0.71;0.5;1
1919;path;1;0;1;0;0.71;0.5;1
1920;plausible;1;0;1;0;0.71;0.5;1
1921;41;1;0;1;0;0.71;0.5;1
1922;53.25;1;0;1;0;0.71;0.5;1
1923;36;1;0;1;0;0.71;0.5;1
1924;nhcs;1;0;1;0;0.71;0.5;1
1925;0.12;1;0;1;0;0.71;0.5;1
1926;intricate;1;0;1;0;0.71;0.5;1
1927;ecological;1;0;1;0;0.71;0.5;1
1928;coactivator-1alpha;1;0;1;0;0.71;0.5;1
1929;cytoplasm;1;0;1;0;0.71;0.5;1
1930;nuclear;1;0;1;0;0.71;0.5;1
1931;undergraduate;1;0;1;0;0.71;0.5;1
1932;iub;1;0;1;0;0.71;0.5;1
1933;bloomington;1;0;1;0;0.71;0.5;1
1934;indiana;1;0;1;0;0.71;0.5;1
1935;parallel;1;0;1;0;0.71;0.5;1
1936;september;1;0;1;0;0.71;0.5;1
1937;q)pcr;1;0;1;0;0.71;0.5;1
1938;mtt;1;0;1;0;0.71;0.5;1
1939;viability;1;0;1;0;0.71;0.5;1
1940;secure;1;0;1;0;0.71;0.5;1
1941;absence;1;0;1;0;0.71;0.5;1
1942;kinase;1;0;1;0;0.71;0.5;1
1943;ampk)/proliferator;1;0;1;0;0.71;0.5;1
1944;cytochrome;1;0;1;0;0.71;0.5;1
1945;lps)-induced;1;0;1;0;0.71;0.5;1
1946;action;1;0;1;0;0.71;0.5;1
1947;reminder;1;0;1;0;0.71;0.5;1
1948;9;1;0;1;0;0.71;0.5;1
1949;nct04620798;1;0;1;0;0.71;0.5;1
1950;clinicaltrials.gov;1;0;1;0;0.71;0.5;1
1951;prospectively;1;0;1;0;0.71;0.5;1
1952;longitudinal;1;0;1;0;0.71;0.5;1
1953;arm;1;0;1;0;0.71;0.5;1
1954;lab;1;0;1;0;0.71;0.5;1
1955;fibrosis;1;0;1;0;0.71;0.5;1
1956;recruitment;1;0;1;0;0.71;0.5;1
1957;send;1;0;1;0;0.71;0.5;1
1958;part;1;0;1;0;0.71;0.5;1
1959;video;1;0;1;0;0.71;0.5;1
1960;instructional;1;0;1;0;0.71;0.5;1
1961;discuss;1;0;1;0;0.71;0.5;1
1962;logistic;1;0;1;0;0.71;0.5;1
1963;mask;1;0;1;0;0.71;0.5;1
1964;near;1;0;1;0;0.71;0.5;1
1965;flaw;1;0;1;0;0.71;0.5;1
1966;xsd;1;0;1;0;0.71;0.5;1
1967;industry;1;0;1;0;0.71;0.5;1
1968;illustrate;1;0;1;0;0.71;0.5;1
1969;environment;1;0;1;0;0.71;0.5;1
1970;flexibility;1;0;1;0;0.71;0.5;1
1971;proposal;1;0;1;0;0.71;0.5;1
1972;straightforwardly;1;0;1;0;0.71;0.5;1
1973;kind;1;0;1;0;0.71;0.5;1
1974;array;1;0;1;0;0.71;0.5;1
1975;root;1;0;1;0;0.71;0.5;1
1976;financial;1;0;1;0;0.71;0.5;1
1977;social;1;0;1;0;0.71;0.5;1
1978;nest;1;0;1;0;0.71;0.5;1
1979;and/or;1;0;1;0;0.71;0.5;1
1980;life;1;0;1;0;0.71;0.5;1
1981;execution;1;0;1;0;0.71;0.5;1
1982;internal;1;0;1;0;0.71;0.5;1
1983;suppress;1;0;1;0;0.71;0.5;1
1984;technological;1;0;1;0;0.71;0.5;1
1985;concealment;1;0;1;0;0.71;0.5;1
1986;cytokine;1;0;1;0;0.71;0.5;1
1987;elisa;1;0;1;0;0.71;0.5;1
1988;qpcr;1;0;1;0;0.71;0.5;1
1989;defect;1;0;1;0;0.71;0.5;1
1990;logistical;1;0;1;0;0.71;0.5;1
1991;ideal;1;0;1;0;0.71;0.5;1
1992;collectively;1;0;1;0;0.71;0.5;1
1993;tunel;1;0;1;0;0.71;0.5;1
1994;stimulation;1;0;1;0;0.71;0.5;1
1995;practical;1;0;1;0;0.71;0.5;1
1996;downregulated;1;0;1;0;0.71;0.5;1
1997;aggravation;1;0;1;0;0.71;0.5;1
1998;frame;1;0;1;0;0.71;0.5;1
1999;participation;1;0;1;0;0.71;0.5;1
2000;destructiveness;1;0;1;0;0.71;0.5;1
2001;confirm;1;0;1;0;0.71;0.5;1
2002;dozen;1;0;1;0;0.71;0.5;1
2003;84;1;0;1;0;0.71;0.5;1
2004;338;1;0;1;0;0.71;0.5;1
2005;227;1;0;1;0;0.71;0.5;1
2006;little;1;0;1;0;0.71;0.5;1
2007;accompany;1;0;1;0;0.71;0.5;1
2008;incentivized;1;0;1;0;0.71;0.5;1
2009;weakly;1;0;1;0;0.71;0.5;1
2010;sufficiently;1;0;1;0;0.71;0.5;1
2011;muv;1;0;1;0;0.71;0.5;1
2012;slope;1;0;1;0;0.71;0.5;1
2013;14.9;1;0;1;0;0.71;0.5;1
2014;23.3;1;0;1;0;0.71;0.5;1
2015;intelligent;1;0;1;0;0.71;0.5;1
2016;-27.4;1;0;1;0;0.71;0.5;1
2017;28.5;1;0;1;0;0.71;0.5;1
2018;creator;1;0;1;0;0.71;0.5;1
2019;final;1;0;1;0;0.71;0.5;1
2020;bespeak;1;0;1;0;0.71;0.5;1
2021;inconsistent;1;0;1;0;0.71;0.5;1
2022;close;1;0;1;0;0.71;0.5;1
2023;qrs;1;0;1;0;0.71;0.5;1
2024;curation;1;0;1;0;0.71;0.5;1
2025;113;1;0;1;0;0.71;0.5;1
2026;provision;1;0;1;0;0.71;0.5;1
2027;xml.making;1;0;1;0;0.71;0.5;1
2028;forget;1;0;1;0;0.71;0.5;1
2029;110;1;0;1;0;0.71;0.5;1
2030;138;1;0;1;0;0.71;0.5;1
2031;validation.the;1;0;1;0;0.71;0.5;1
2032;iterative;1;0;1;0;0.71;0.5;1
2033;v2;1;0;1;0;0.71;0.5;1
2034;v0.9.22;1;0;1;0;0.71;0.5;1
2035;spreadsheet.we;1;0;1;0;0.71;0.5;1
2036;tpte;1;0;1;0;0.71;0.5;1
2037;88;1;0;1;0;0.71;0.5;1
2038;release;1;0;1;0;0.71;0.5;1
2039;conceptualize;1;0;1;0;0.71;0.5;1
2040;demographic;1;0;1;0;0.71;0.5;1
2041;manifestation;1;0;1;0;0.71;0.5;1
2042;invest;1;0;1;0;0.71;0.5;1
2043;dktk;1;0;1;0;0.71;0.5;1
2044;gba;1;0;1;0;0.71;0.5;1
2045;dissemination;1;0;1;0;0.71;0.5;1
2046;pitfall;1;0;1;0;0.71;0.5;1
2047;participate;1;0;1;0;0.71;0.5;1
2048;etc;1;0;1;0;0.71;0.5;1
2049;id;1;0;1;0;0.71;0.5;1
2050;globally;1;0;1;0;0.71;0.5;1
2051;spread;1;0;1;0;0.71;0.5;1
2052;contagious;1;0;1;0;0.71;0.5;1
2053;thousand;1;0;1;0;0.71;0.5;1
2054;socioeconomic;1;0;1;0;0.71;0.5;1
2055;organism;1;0;1;0;0.71;0.5;1
2056;104;1;0;1;0;0.71;0.5;1
2057;openly;1;0;1;0;0.71;0.5;1
2058;33;1;0;1;0;0.71;0.5;1
2059;depolarization;1;0;1;0;0.71;0.5;1
2060;repolarization;1;0;1;0;0.71;0.5;1
2061;http://covidterm.imicams.ac.cn;1;0;1;0;0.71;0.5;1
2062;url;1;0;1;0;0.71;0.5;1
2063;online;1;0;1;0;0.71;0.5;1
2064;887;1;0;1;0;0.71;0.5;1
2065;qualifier;1;0;1;0;0.71;0.5;1
2066;724;1;0;1;0;0.71;0.5;1
2067;464;1;0;1;0;0.71;0.5;1
2068;respectively;1;0;1;0;0.71;0.5;1
2069;core;1;0;1;0;0.71;0.5;1
2070;institution;1;0;1;0;0.71;0.5;1
2071;assistance;1;0;1;0;0.71;0.5;1
2072;psychology;1;0;1;0;0.71;0.5;1
2073;luminescence;1;0;1;0;0.71;0.5;1
2074;metafor;1;0;1;0;0.71;0.5;1
2075;populate;1;0;1;0;0.71;0.5;1
2076;cycle;1;0;1;0;0.71;0.5;1
2077;purification;1;0;1;0;0.71;0.5;1
2078;commercial;1;0;1;0;0.71;0.5;1
2079;butanoate;1;0;1;0;0.71;0.5;1
2080;propanoate;1;0;1;0;0.71;0.5;1
2081;alanine;1;0;1;0;0.71;0.5;1
2082;aspartate;1;0;1;0;0.71;0.5;1
2083;glutamate;1;0;1;0;0.71;0.5;1
2084;retinol;1;0;1;0;0.71;0.5;1
2085;purine;1;0;1;0;0.71;0.5;1
2086;pentose;1;0;1;0;0.71;0.5;1
2087;stepwise;1;0;1;0;0.71;0.5;1
2088;employ;1;0;1;0;0.71;0.5;1
2089;phosphate;1;0;1;0;0.71;0.5;1
2090;aminoacyl;1;0;1;0;0.71;0.5;1
2091;byproduct;1;0;1;0;0.71;0.5;1
2092;inexpensive;1;0;1;0;0.71;0.5;1
2093;abundant;1;0;1;0;0.71;0.5;1
2094;deficient;1;0;1;0;0.71;0.5;1
2095;regeneration;1;0;1;0;0.71;0.5;1
2096;nadph;1;0;1;0;0.71;0.5;1
2097;xylulose;1;0;1;0;0.71;0.5;1
2098;blank;1;0;1;0;0.71;0.5;1
2099;delete;1;0;1;0;0.71;0.5;1
2100;inhibit;1;0;1;0;0.71;0.5;1
2101;uracil;1;0;1;0;0.71;0.5;1
2102;carbon;1;0;1;0;0.71;0.5;1
2103;tca;1;0;1;0;0.71;0.5;1
2104;pollutant;1;0;1;0;0.71;0.5;1
2105;organic;1;0;1;0;0.71;0.5;1
2106;remainder;1;0;1;0;0.71;0.5;1
2107;caramel;1;0;1;0;0.71;0.5;1
2108;portion;1;0;1;0;0.71;0.5;1
2109;dispense;1;0;1;0;0.71;0.5;1
2110;auto;1;0;1;0;0.71;0.5;1
2111;yarrowia;1;0;1;0;0.71;0.5;1
2112;trna;1;0;1;0;0.71;0.5;1
2113;uniform;1;0;1;0;0.71;0.5;1
2114;thread;1;0;1;0;0.71;0.5;1
2115;capability;1;0;1;0;0.71;0.5;1
2116;cache;1;0;1;0;0.71;0.5;1
2117;serialization;1;0;1;0;0.71;0.5;1
2118;benchmark;1;0;1;0;0.71;0.5;1
2119;warehouse;1;0;1;0;0.71;0.5;1
2120;neutral;1;0;1;0;0.71;0.5;1
2121;curate;1;0;1;0;0.71;0.5;1
2122;decide;1;0;1;0;0.71;0.5;1
2123;somatic;1;0;1;0;0.71;0.5;1
2124;rnas;1;0;1;0;0.71;0.5;1
2125;fuse;1;0;1;0;0.71;0.5;1
2126;workflow;1;0;1;0;0.71;0.5;1
2127;perl;1;0;1;0;0.71;0.5;1
2128;lncrna-;1;0;1;0;0.71;0.5;1
2129;eu;1;0;1;0;0.71;0.5;1
2130;european;1;0;1;0;0.71;0.5;1
2131;valine;1;0;1;0;0.71;0.5;1
2132;citizen;1;0;1;0;0.71;0.5;1
2133;inversion;1;0;1;0;0.71;0.5;1
2134;contact;1;0;1;0;0.71;0.5;1
2135;dispenser;1;0;1;0;0.71;0.5;1
2136;dataflow;1;0;1;0;0.71;0.5;1
2137;inverse;1;0;1;0;0.71;0.5;1
2138;leucine;1;0;1;0;0.71;0.5;1
2139;union;1;0;1;0;0.71;0.5;1
2140;quick;1;0;1;0;0.71;0.5;1
2141;isoleucine;1;0;1;0;0.71;0.5;1
2142;degradation;1;0;1;0;0.71;0.5;1
2143;novelty;1;0;1;0;0.71;0.5;1
2144;ehealth;1;0;1;0;0.71;0.5;1
2145;upstream;1;0;1;0;0.71;0.5;1
2146;heterologous;1;0;1;0;0.71;0.5;1
2147;lipolytica;1;0;1;0;0.71;0.5;1
2148;phenomenon;1;0;1;0;0.71;0.5;1
2149;orchioides;1;0;1;0;0.71;0.5;1
2150;fidelity;1;0;1;0;0.71;0.5;1
2151;iteration;1;0;1;0;0.71;0.5;1
2152;preprocess;1;0;1;0;0.71;0.5;1
2153;prisma;1;0;1;0;0.71;0.5;1
2154;item;1;0;1;0;0.71;0.5;1
2155;definition;1;0;1;0;0.71;0.5;1
2156;18.9;1;0;1;0;0.71;0.5;1
2157;831;1;0;1;0;0.71;0.5;1
2158;reach;1;0;1;0;0.71;0.5;1
2159;reviewer;1;0;1;0;0.71;0.5;1
2160;proportion;1;0;1;0;0.71;0.5;1
2161;substance;1;0;1;0;0.71;0.5;1
2162;pool;1;0;1;0;0.71;0.5;1
2163;25;1;0;1;0;0.71;0.5;1
2164;particular;1;0;1;0;0.71;0.5;1
2165;fpgas;1;0;1;0;0.71;0.5;1
2166;11;1;0;1;0;0.71;0.5;1
2167;mistake;1;0;1;0;0.71;0.5;1
2168;miscellaneous;1;0;1;0;0.71;0.5;1
2169;.05;1;0;1;0;0.71;0.5;1
2170;significance;1;0;1;0;0.71;0.5;1
2171;equation;1;0;1;0;0.71;0.5;1
2172;imputation;1;0;1;0;0.71;0.5;1
2173;impute;1;0;1;0;0.71;0.5;1
2174;ease;1;0;1;0;0.71;0.5;1
2175;antipsychotic;1;0;1;0;0.71;0.5;1
2176;placebo;1;0;1;0;0.71;0.5;1
2177;antidepressant;1;0;1;0;0.71;0.5;1
2178;agonist;1;0;1;0;0.71;0.5;1
2179;dopamine;1;0;1;0;0.71;0.5;1
2180;anticonvulsant;1;0;1;0;0.71;0.5;1
2181;psychostimulants;1;0;1;0;0.71;0.5;1
2182;opioid;1;0;1;0;0.71;0.5;1
2183;curculigo;1;0;1;0;0.71;0.5;1
2184;retention;1;0;1;0;0.71;0.5;1
2185;gluconic;1;0;1;0;0.71;0.5;1
2186;enroll;1;0;1;0;0.71;0.5;1
2187;lipid;1;0;1;0;0.71;0.5;1
2188;license?></xml;1;0;1;0;0.71;0.5;1
2189;xml><?covid;1;0;1;0;0.71;0.5;1
2190;92.40;1;0;1;0;0.71;0.5;1
2191;h(-;1;0;1;0;0.71;0.5;1
2192;0.82;1;0;1;0;0.71;0.5;1
2193;fermenter;1;0;1;0;0.71;0.5;1
2194;5-l;1;0;1;0;0.71;0.5;1
2195;histopathological;1;0;1;0;0.71;0.5;1
2196;120;1;0;1;0;0.71;0.5;1
2197;97.10;1;0;1;0;0.71;0.5;1
2198;succinate;1;0;1;0;0.71;0.5;1
2199;optimization;1;0;1;0;0.71;0.5;1
2200;glucose;1;0;1;0;0.71;0.5;1
2201;pcr;1;0;1;0;0.71;0.5;1
2202;airborne;1;0;1;0;0.71;0.5;1
2203;blood;1;0;1;0;0.71;0.5;1
2204;inhale;1;0;1;0;0.71;0.5;1
2205;europe;1;0;1;0;0.71;0.5;1
2206;2015;1;0;1;0;0.71;0.5;1
2207;8731;1;0;1;0;0.71;0.5;1
2208;materia;1;0;1;0;0.71;0.5;1
2209;medica;1;0;1;0;0.71;0.5;1
2210;diet;1;0;1;0;0.71;0.5;1
2211;yang;1;0;1;0;0.71;0.5;1
2212;pharmacotherapy;1;0;1;0;0.71;0.5;1
2213;air;1;0;1;0;0.71;0.5;1
2214;psychosocial;1;0;1;0;0.71;0.5;1
2215;illicit;1;0;1;0;0.71;0.5;1
2216;kingdom;1;0;1;0;0.71;0.5;1
2217;unite;1;0;1;0;0.71;0.5;1
2218;importance;1;0;1;0;0.71;0.5;1
2219;water;1;0;1;0;0.71;0.5;1
2220;pave;1;0;1;0;0.71;0.5;1
2221;kyoto;1;0;1;0;0.71;0.5;1
2222;multiscale;1;0;1;0;0.71;0.5;1
2223;hard;1;0;1;0;0.71;0.5;1
2224;consistently;1;0;1;0;0.71;0.5;1
2225;productive;1;0;1;0;0.71;0.5;1
2226;putt;1;0;1;0;0.71;0.5;1
2227;nowadays;1;0;1;0;0.71;0.5;1
2228;stamp;1;0;1;0;0.71;0.5;1
2229;person;1;0;1;0;0.71;0.5;1
2230;http;1;0;1;0;0.71;0.5;1
2231;prototype;1;0;1;0;0.71;0.5;1
2232;additionally;1;0;1;0;0.71;0.5;1
2233;nonprogrammers;1;0;1;0;0.71;0.5;1
2234;plus;1;0;1;0;0.71;0.5;1
2235;descriptive;1;0;1;0;0.71;0.5;1
2236;asian;1;0;1;0;0.71;0.5;1
2237;gain;1;0;1;0;0.71;0.5;1
2238;reliably;1;0;1;0;0.71;0.5;1
2239;miner;1;0;1;0;0.71;0.5;1
2240;workforce;1;0;1;0;0.71;0.5;1
2241;sufficient;1;0;1;0;0.71;0.5;1
2242;internationally;1;0;1;0;0.71;0.5;1
2243;medbiquitous;1;0;1;0;0.71;0.5;1
2244;recruit;1;0;1;0;0.71;0.5;1
2245;hr;1;0;1;0;0.71;0.5;1
2246;europass;1;0;1;0;0.71;0.5;1
2247;worker;1;0;1;0;0.71;0.5;1
2248;selectable;1;0;1;0;0.71;0.5;1
2249;greatly;1;0;1;0;0.71;0.5;1
2250;supply;1;0;1;0;0.71;0.5;1
2251;accuracy;1;0;1;0;0.71;0.5;1
2252;ongoing;1;0;1;0;0.71;0.5;1
2253;safely;1;0;1;0;0.71;0.5;1
2254;qualification;1;0;1;0;0.71;0.5;1
2255;3.2;1;0;1;0;0.71;0.5;1
2256;overview;1;0;1;0;0.71;0.5;1
2257;bind;1;0;1;0;0.71;0.5;1
2258;specialize;1;0;1;0;0.71;0.5;1
2259;encyclopedia;1;0;1;0;0.71;0.5;1
2260;sensitive;1;0;1;0;0.71;0.5;1
2261;dominate;1;0;1;0;0.71;0.5;1
2262;irradiation;1;0;1;0;0.71;0.5;1
2263;reliability;1;0;1;0;0.71;0.5;1
2264;pair;1;0;1;0;0.71;0.5;1
2265;checkable;1;0;1;0;0.71;0.5;1
2266;intensity;1;0;1;0;0.71;0.5;1
2267;irradiate;1;0;1;0;0.71;0.5;1
2268;ability;1;0;1;0;0.71;0.5;1
2269;distinguish;1;0;1;0;0.71;0.5;1
2270;molecule;1;0;1;0;0.71;0.5;1
2271;13,531;1;0;1;0;0.71;0.5;1
2272;megavoltage;1;0;1;0;0.71;0.5;1
2273;mayor;1;0;1;0;0.71;0.5;1
2274;18,744;1;0;1;0;0.71;0.5;1
2275;tailor;1;0;1;0;0.71;0.5;1
2276;plausibility;1;0;1;0;0.71;0.5;1
2277;exhibit;1;0;1;0;0.71;0.5;1
2278;inconsistently;1;0;1;0;0.71;0.5;1
2279;subcutaneous;1;0;1;0;0.71;0.5;1
2280;publicly;1;0;1;0;0.71;0.5;1
2281;pmcs;1;0;1;0;0.71;0.5;1
2282;scenario;1;0;1;0;0.71;0.5;1
2283;subset;1;0;1;0;0.71;0.5;1
2284;carefully;1;0;1;0;0.71;0.5;1
2285;superficial;1;0;1;0;0.71;0.5;1
2286;proflavine;1;0;1;0;0.71;0.5;1
2287;proflavin;1;0;1;0;0.71;0.5;1
2288;window;1;0;1;0;0.71;0.5;1
2289;optical;1;0;1;0;0.71;0.5;1
2290;in-;1;0;1;0;0.71;0.5;1
2291;fluorescence;1;0;1;0;0.71;0.5;1
2292;exclusion;1;0;1;0;0.71;0.5;1
2293;quantum;1;0;1;0;0.71;0.5;1
2294;profile;1;0;1;0;0.71;0.5;1
2295;fully;1;0;1;0;0.71;0.5;1
2296;200;1;0;1;0;0.71;0.5;1
2297;prior;1;0;1;0;0.71;0.5;1
2298;lasso;1;0;1;0;0.71;0.5;1
2299;81;1;0;1;0;0.71;0.5;1
2300;fructus;1;0;1;0;0.71;0.5;1
2301;arctii;1;0;1;0;0.71;0.5;1
2302;niubangzi;1;0;1;0;0.71;0.5;1
2303;radix;1;0;1;0;0.71;0.5;1
2304;flavescentis;1;0;1;0;0.71;0.5;1
2305;sophorae;1;0;1;0;0.71;0.5;1
2306;kushen;1;0;1;0;0.71;0.5;1
2307;herba;1;0;1;0;0.71;0.5;1
2308;schizonepetae;1;0;1;0;0.71;0.5;1
2309;jingjie;1;0;1;0;0.71;0.5;1
2310;rhizome;1;0;1;0;0.71;0.5;1
2311;macrocephalae;1;0;1;0;0.71;0.5;1
2312;atractylodis;1;0;1;0;0.71;0.5;1
2313;th17;1;0;1;0;0.71;0.5;1
2314;differentiation;1;0;1;0;0.71;0.5;1
2315;pi3k;1;0;1;0;0.71;0.5;1
2316;cynarine;1;0;1;0;0.71;0.5;1
2317;ol;1;0;1;0;0.71;0.5;1
2318;24s)-24-propylcholesta-5-ene-3beta;1;0;1;0;0.71;0.5;1
2319;sitosterol;1;0;1;0;0.71;0.5;1
2320;beta;1;0;1;0;0.71;0.5;1
2321;kushenol;1;0;1;0;0.71;0.5;1
2322;stigmasterin;1;0;1;0;0.71;0.5;1
2323;vitamin;1;0;1;0;0.71;0.5;1
2324;akt;1;0;1;0;0.71;0.5;1
2325;retinoid;1;0;1;0;0.71;0.5;1
2326;proliferator;1;0;1;0;0.71;0.5;1
2327;peroxisome;1;0;1;0;0.71;0.5;1
2328;anhydrase;1;0;1;0;0.71;0.5;1
2329;carbonic;1;0;1;0;0.71;0.5;1
2330;enrichment;1;0;1;0;0.71;0.5;1
2331;baizhu;1;0;1;0;0.71;0.5;1
2332;herb;1;0;1;0;0.71;0.5;1
2333;medicinal;1;0;1;0;0.71;0.5;1
2334;occurrence;1;0;1;0;0.71;0.5;1
2335;overexpress;1;0;1;0;0.71;0.5;1
2336;cd4;1;0;1;0;0.71;0.5;1
2337;t;1;0;1;0;0.71;0.5;1
2338;pparg;1;0;1;0;0.71;0.5;1
2339;uncover;1;0;1;0;0.71;0.5;1
2340;nk;1;0;1;0;0.71;0.5;1
2341;progression;1;0;1;0;0.71;0.5;1
2342;formula;1;0;1;0;0.71;0.5;1
2343;consult;1;0;1;0;0.71;0.5;1
2344;practitioner;1;0;1;0;0.71;0.5;1
2345;applicant;1;0;1;0;0.71;0.5;1
2346;ineligible;1;0;1;0;0.71;0.5;1
2347;toolbox;1;0;1;0;0.71;0.5;1
2348;regulator;1;0;1;0;0.71;0.5;1
2349;parp8;1;0;1;0;0.71;0.5;1
2350;ecm_receptor_interaction;1;0;1;0;0.71;0.5;1
2351;elucidate;1;0;1;0;0.71;0.5;1
2352;sleep;1;0;1;0;0.71;0.5;1
2353;tightly;1;0;1;0;0.71;0.5;1
2354;pediatric;1;0;1;0;0.71;0.5;1
2355;antihistamine;1;0;1;0;0.71;0.5;1
2356;steroid;1;0;1;0;0.71;0.5;1
2357;topical;1;0;1;0;0.71;0.5;1
2358;univariate;1;0;1;0;0.71;0.5;1
2359;itch;1;0;1;0;0.71;0.5;1
2360;deficiency;1;0;1;0;0.71;0.5;1
2361;cox;1;0;1;0;0.71;0.5;1
2362;integrative;1;0;1;0;0.71;0.5;1
2363;san;1;0;1;0;0.71;0.5;1
2364;feng;1;0;1;0;0.71;0.5;1
2365;xiao;1;0;1;0;0.71;0.5;1
2366;barrier;1;0;1;0;0.71;0.5;1
2367;moderate;0;1;1;0;0.71;0.5;1
